<p id="1"><s id="1:1">بە هۆی پەتایی کۆڕۆناوە بەشێکی زۆر لە هاووڵاتیانی جیهان لە ماڵەکانی خۆیاندا دەمێننەوە، بەشێک لەو گەنجەکانەی کە دەیانخواست لەم قۆناغەدا کارێکی باش بکەن، لە ڕێگەی فێرگەی کوردییەوە دەست بە کاربوون بۆ کارەکەیان.</s>	<s id="1:1">While people in most parts of the world remain in their homes due to the COVID-19 pandemic, people who want to make the best out of this lockdown have become a course at Fêrgeha Kurdî.</s>
<s id="1:2">گوندی حاجیکاش شوێنی ژیانی هاوبەشی کورد و ئەرمەن بوو.</s>	<s id="1:2">​​Kurds and Armenians lived together in the village of Hacıkaş.</s>
<s id="1:3">ئەو گوندە 3 جار لەلایەن دەوڵەتی تورکیاوە سوتێنرا.</s>	<s id="1:3">The village was burnt down three times by the Turkish state.</s>
<s id="1:4">دەوڵەتی تورکیا ساڵی 1930 و لەکاتی کۆمەڵکوژیی زیلاندا بەشێکی زۆر لە دانیشتوانی گوندی حاجیکاش کوشت و ئەوەشی مایەوە ڕایگواستن.</s>	<s id="1:4">The Turkish state slaughtered a high number of Hacıkaş villagers in the 1930's, while many people were exiled in the massacre of Zilan.</s>
<s id="1:5">گوندەکە لە دوای ئەو کۆمەڵکوژییە بەتەواوی چۆڵکرا.</s>	<s id="1:5">After the massacre, the village was completely vacated.</s>
<s id="1:6">یەکێک لەو شوێنەوارانە پەرستگەی مێژوویی حاجی بوو.</s>	<s id="1:6">One of these buildings was the Haj Church, the historic Armenian Church.</s>
<s id="1:7">ئەو کاتە گوندەکە ناوی کاش بوو.</s>	<s id="1:7">At that time the name of the village was Kaş.</s>
<s id="1:8">بەپێی زانیاریی هەندێک لە هاووڵاتییانی ئەو گوندە، مێژووی ئەو گوندە و پەرستگەکە دەگەڕێتەوە بۆ 3 هەزار ساڵ لەوە پێش و بۆ سەردەمی ئورارتوییەکان.</s>	<s id="1:8">According to some villagers, this church was built on the site of a 3 thousand years old temple of the Urartu period.</s>
<s id="1:9">هەفتەی کولتووری کوردی لە شاری بڕۆسکلی پایتەختی بەلجیکا لە ڕۆژی دووەمدا بە هەڵپەڕکێ و گۆرانی بەردەوامە.</s>	<s id="1:9">The Kurdish Culture Week started with a march from Brouckere to Espagne squares.</s>
<s id="1:10">بۆ شەشەمین ساڵ هەفتەی کولتووری کوردی لە شاری بڕۆکسل بەڕێوەدەچێت.</s>	<s id="1:10">The 6th edition of the Kurdish Culture Week has begun in Brussels.</s>
<s id="1:11">لە مەیدانی ئیسپانیا کە چالاکییەکانی تێدا بەڕێوەدەچێت، چادرەکانی ئەنستیتوی کوردی بڕۆکسل، ڕێکخراوی مافی مرۆڤ - کوردۆساید و چادری کتێب و خواردنە کوردییەکان دانراوە.</s>	<s id="1:11">The event area in Espagne square included replicas of historical buildings in Kurdistan, a stand where Kurdish culture and cousine can be tasted, a stage for concerts, book stands.</s>
<s id="1:12">بوونی ئێوە خۆی لە خۆیدا سەرکەوتنە.</s>	<s id="1:12">Your presence alone is a victory.</s>
<s id="1:13">ڕابوون لەدژی ستەمکاریی سەرکەوتنە.</s>	<s id="1:13">The very act of refusing oppression is a victory.</s>
<s id="1:14">شەڕکردن سەرکەوتنە.</s>	<s id="1:14">Fighting is a victory.</s>
<s id="1:15">تاکە شتێک کە ئەوان دەیکوژن، ترسی ئێمەیە.</s>	<s id="1:15">All they have killed is our fear.</s>
<s id="1:16">لە جێگەی هەر ژنێک کە ئێوە دەڕفێنن، شەڕڤانێکی نوێ دروست دەبێت.</s>	<s id="1:16">With each sister who was captured, a warrior was born.</s>
<s id="1:17">ئەو وتانەی وەک هەڵبەستێک نوسراوەتەوە، هەڵبەست نین، ئەو وتانە لە دیالۆگی فیلمی' کچانی ڕۆژ' دا وتراون.</s>	<s id="1:17">These poetic words continue, but they are not from any poem. These are from the Girls of the Sun film.</s>
<s id="1:18">فیلمی کچانی ڕۆژ باس لە تێکۆشانی ژنانی کورد دەکات دژ بە چەتەکانی داعش.</s>	<s id="1:18">The Girls of the Sun film is about the Kurdish women’s fight against ISIS gangs.</s>
<s id="1:19">فیلمی 'کچانی ڕۆژ لە 71هەمین فێستیڤاڵی نێودەوڵەتیی کان لە فەرەنسا یەکێک بوو لەو 21 فیلم کە بۆ وەرگرتنی خەڵاتی زێڕین، لە پێشبڕکێدایە.</s>	<s id="1:19">“Girls of the Sun” is among the 21 films running for the Golden Palm in the 71st International Film Festival, and was screened on Saturday for curious audiences.</s>
<s id="1:20">فیلمی ' کچانی ڕۆژ' باس لە شەڕی ژنانی کورد دەکات دژ بە داعش، ماوەکەی یەک کاتژمێر و 55 خولەکە.</s>	<s id="1:20">The film is about Kurdish women fighting ISIS, and is 115 minutes long.</s>
<s id="1:21">دەرهێنەری فیلمەکە ئێڤا هوسۆن کە کەسایەتیی ئێزیدیە چیرۆکی فیلمەکەی باس لە کچێک بە ناوی بەهار دەکات کە لەلایەن داعشەوە بە دیل گیرابوو، پاشان ئازاد کراوە.</s>	<s id="1:21">Director Eva Husson reflects these concepts through an Êzidî woman, Bahar, who was captured by ISIS and achieved freedom later on.</s>
<s id="1:22">سەرکەوتنی ژنی کورد.</s>	<s id="1:22">Kurdish women’s victory</s>
<s id="1:23">فیلمەکە سەرنج دەخاتە سەر هێرشی چەتەکانی داعش بۆ سەر شەنگال، هەروەها کۆمەڵکوژیی و بە دیلگرتنی ژنان و سەرکەوتنی ژنان لە شەڕی دژ بە داعشدا نیشان دەدات.</s>	<s id="1:23">The film focuses on the ISIS attack against ISIS, the massacre, the capture of women and the victory of women who fought them.</s>
<s id="1:24">شەڕ، مردن و شڵەژان</s>	<s id="1:24">WAR, DEATH AND PANIC</s>
<s id="1:25">کارەکتەری سەرەکی لە فیلمەکەدا بەهارە.</s>	<s id="1:25">The main character in the film, Bahar.</s>
<s id="1:26">ئەو کارەکتەرە لەلایەن خامنە ئەکتەری ئێرانی گوڵشیفتە فەراهانییەوە بەرجەستە دەکرێت کە گوڵشیفتە لە سیرگون-ی فەرانسا دەژی و لە فیلمەکانی بەهمەنی قوبادی'دا ناسراوە.</s>	<s id="1:26">It is played by exiled Iranian actress Golshifteh Farahani, who is known for her roles in Bahman Ghobadi films.</s>
<s id="1:27">لە دەستپێکی فیلمەکەدا ڕۆژنامەوانی فەرەنسیی مات هیلدە بە ڕێگای هەلیکۆپتەرێک دەگاتە چیای شەنگال و لەلایەن شەرڤانانی ژنەوە پێشوازیی لێدەکرێت.</s>	<s id="1:27">The film opens with French journalist Mathilde arriving in the Shengal mountains with a helicopter. The journalist is received by the fighter women.</s>
<s id="1:28">لە گفتوگۆکانی کاتی پێشوازیەکەدا دەردەکەوێت کە ئەو ڕۆژنامەوانە پێشتر لە کۆبانێ بووە و چەند شەڕڤانێکی ژنی ناسیوە.</s>	<s id="1:28">The dialogue suggests that the journalist has been in Kobanê before, and knows some of the women from there.</s>
<s id="1:29">لە فیلمەکەدا کە تێیدا شەڕ، مردن و شڵەژان تێپەڕدەبن، ماتهیڵدە و بەهار ڕووبەڕووی یەکتر دەبنەوە و شەڕڤانانی ژنی کورد هەوڵ دەدەن گوند و شارۆچکەکان لە داعشیەکان ڕزگار بکەن.</s>	<s id="1:29">We witness Mathilde and Bahar’s encounter as the film continues in an atmosphere of war, death and panic as Kurdish fighter women are trying to save the villages and towns from ISIS.</s>
<s id="1:30">ئازار، لەدەستدانی خۆشەویستان و دڵدارانی ئازادی</s>	<s id="1:30">Pain, loss and a passion for freedom</s>
<s id="1:31">بەهار کارەکتەرێکی گورجوگۆڵ، بە حرس و دیسپلینە.</s>	<s id="1:31">Bahar has an image of the harsh, angry and disciplined fighter.</s>
<s id="1:32">بەڵام تایبەتمەندیی هاوبەشیان ئەوەیە کە هەردووکیان ژن و دایکن.</s>	<s id="1:32">What they have in common is that they are both women, and mothers.</s>
<s id="1:33">ئەوەش ئەو دوو ژنە زیاتر لەیەکتر نزیک دەکاتەوە.</s>	<s id="1:33">This brings them closer.</s>
<s id="1:34">بەهار لە فەرەنسا خوێندوویەتیی و کاتێک دەگەڕێتەوە بۆ شەنگال بەمەبەستی سەردانی بنەماڵەکەی، بەهۆی هێرشی داعشەوە هاوسەرەکەی لەدەست دەدات و خۆی و کوڕەکەشی لەلایەن داعشەوە دەڕفێنرێن و دەستدرێژیان دەکرێتە سەر. پاشان بەهار ئازاد دەکرێت و دەبێتە شەڕڤان.</s>	<s id="1:34">Bahar is a fighter woman who studied in France, and who lost her husband in the ISIS attack during her visit to her family in Shengal, was captured along with her son, was raped, but later managed to get her freedom.</s>
<s id="1:35">ماتهیلدە هەواڵنێریی جەنگە.</s>	<s id="1:35">Mathilde is a war correspondent journalist.</s>
<s id="1:36">هاوسەرەکەیشی کە هەمان پیشەی هەبوو، لە شەڕێکدا گیانی لەدەست دەدات و کوڕەکەشی بە تەنها لە فەرەنسایە و هەمیشە دڵ و مێشکی لایەتی.</s>	<s id="1:36">She lost her husband who had the same job in another war, and is worried for her child who is alone in France.</s>
<s id="1:37">لەدەستدان و گەڕانەکانیان لە ژن و دایکبوونیان زیاتر دەبێت، هەروەها ئازارەکانیشیان زیاتر دەبن.</s>	<s id="1:37">Their losses and searches are added to their womanhood and motherhood, and they have similar pains.</s>
<s id="1:38">تێکۆشان دژ بە پیاوسالاریی</s>	<s id="1:38">FIGHTING THE MALE MIND</s>
<s id="1:39">فیلمی 'کچانی ڕۆژ' تەنها باس لە شەڕی ژنانی کورد دژ بە داعش ناکات، بەڵکو ژیانی شەڕڤانی و تێکۆشەریی ژنان لە شەنگال دەخاتە پێش چاوان.</s>	<s id="1:39">The film Girls of the Sun doesn’t only analyze women’s fight against ISIS, it also stresses the fighting character of the women in Shengal.</s>
<s id="1:40">بەتایبەتی سەرنج دەخاتە سەر کۆمەڵێک شەرڤانی پیاو لە شەنگال کە نایانەوێت تێکۆشانی هاوبەش لەگەڵ ژنان بەرێوەبەرن.</s>	<s id="1:40">It points out that some male fighter groups didn’t participate in the joint struggle in Shengal.</s>
<s id="1:41">شەرڤانانی ژن کە بەهار فەرماندەیانە لەلایەک دژ بە چەتەکانی داعش دەجەنگن و لەلایەکی ترەوە دژ بەو کلتوری پیاوسالاری.</s>	<s id="1:41">The women under Bahar’s command fight both ISIS, and this mentality.</s>
<s id="1:42">لە فیلمەکەدا، سەرەڕای تایبەتمەندیی شەڕڤانان و بەرخودێرییان، لایەنکانی سۆزداریی، هەستیاریی و مرۆیی ژنانی کورد نیشان دەدرێن.</s>	<s id="1:42">The film brings to the light both the figting, resisting side of Kurdish women and their emotional, delicate and humane sides.</s>
<s id="1:43">هەروەها لە فیلمەکەدا گۆرانی سۆرانی دەچڕدرێت و گۆڤەند و هەڵپەڕکێ دەگیردرێت و ئاماژە بە ژیانی گەریلاکانی کورد دەکرێت.</s>	<s id="1:43">Songs in the Sorani dialect and dances reference the daily lives of Kurdish guerillas.</s>
<s id="1:44">هەروەها لە فیلمەکەدا باس لە هەوڵەکان دەکرێت بۆ ڕزگارکردنی ژنە بە دیلگیراوەکان و دۆخی ئەو ژنانەش دەخرێتە ڕوو کە لە بازاڕەکاندا فرۆشراون.</s>	<s id="1:44">The film shows attempts to rescue the enslaved women and the conditions of women who were sold off, and gives credit to the positive role some imams played in the rescue.</s>
<s id="1:45">'کچانی ڕۆژ' فیلمی ژنانە</s>	<s id="1:45">GIRLS OF THE SUN IS A WOMEN’S FILM</s>
<s id="1:46">لە کۆتایی فیلمەکەدا شەڕڤانانی ژنی کورد بە ڕێگای تونێل لێدان، دەدەن بەسەر ناوەندی چەتەکانی داعشدا.</s>	<s id="1:46">The film ends with the Kurdish fighter women using tunnels to raid the headquarters of ISIS members.</s>
<s id="1:47">لەکاتی شەڕی ناو شاریشدا، بەهۆی بۆمبارانی فڕۆکە جەنگیەکانی هێزی هاوپەیمانانەوە ڕۆژنامەوان ماتهیڵدە بریندار دەبێت.</s>	<s id="1:47">While Mathilde is wounded in a Coalition bombing during clashes in the city.</s>
<s id="1:48">لە ڕۆڵی سەرەکی فیلمەکەدا گوڵشیفتەن فەراهانی، ئێمانوێل بێرکۆت بەشدارن. ئەکتەری ئێزدی زوبەیدە بولوت ڕۆڵی لامیا بەرجەستە دەکات.</s>	<s id="1:48">Lead actresses Golshifteh Farahani and Emmanuelle Bercot are accompanied by Êzidî actress Zübeyde Bulut in the role of Lamia.</s>
<s id="1:49">ئەگەری ئەوە هەیە کە هەرچۆنێک بێت ئەو فیلمە خەڵاتێک وەربگرێت.</s>	<s id="1:49">It looks like it will take home some awards from the festival.</s>
<s id="1:50">ئاوازی چیا تیپی مۆسیقای گەریلا ئەمجارە کلیپێکی بۆ گۆرانییەکی نوێ بە ناوی "لە چیاوە بەرەو دەریا" ئامادە کرد و بڵاویکردەوە.</s>	<s id="1:50">Awazê Çiya music band composed of guerrillas has released a new song called “From mountains to seas”.</s>
<s id="1:51">لە کۆی 200 وڵاتی جیهان، ئێران لەو دەگمەن وڵاتانەیە کە خوێندن و فێربوونی زمانی دایکیی تێیدا ڕێگەپێنەدراوە.</s>	<s id="1:51">Among 200 countries, Iran is one of the few in which reading and learning in mother language is prohibited.</s>
<s id="1:52">لە ڕاگەیاندراوی ئەو ڕێکخراوانەدا هاتووە "لە کۆی 200 وڵاتی جیهان، ئێران لەو دەگمەن وڵاتانەیە کە خوێندن و فێربوونی زمانی دایکیی تێیدا ڕێگەپێنەدراوە."</s>	<s id="1:52">“Among 200 countries, Iran is one of the few in which reading and learning in mother language is prohibited,” the statement said.</s>
<s id="1:53">راشیانگەیاندووە "سەپاندنی سیستەمی خوێندن و فێرکاری فەرمی تەنیا بە یەک زمان، هێمایەکی ڕوونی زمان کوژییە کە دەبێتە هۆی لاواز بوونی پێگەی کۆمەڵایەتی زمانەکانی دیکەی ئێران و ئاڵۆز کردنی جەوهەر و ناوەرۆک و هەروەها دەوری گواستنەوەیان لە نەوەیەک بۆ نەوەکانی داهاتوو".</s>	<s id="1:53">It was also pointed out that “Imposing a system of formal reading and learning into a single language is an obvious act of killing languages that undermines the social status of other languages of the peoples of Iran.”</s>
<s id="1:54">"کوشتنی زمانی دایکیی هەمان ڕەگەزپەرەستی و پاکتاوی نژادییە.</s>	<s id="1:54">“Killing a mother tongue is the same as racism and ethnic cleansing.</s>
<s id="1:55">کۆمەڵگایەک کە تاکە یەک زمان بە سەر زمانەکانی دیکەدا دەسەپێنیت، کۆمەڵگەیەکی ڕەگەزپەرەستە.</s>	<s id="1:55">A society that imposes only one language over other languages is a racist society.</s>
<s id="1:56">هیچ جیاوازییەک نییە ئەگەر ئێوە ڕەگەزێک داسەپێنن بە سەر ڕەگەزەکانی دیکەدا یا زمانێک، یا ئایینێک، یا ئیدئۆلۆژییە.</s>	<s id="1:56">There is no difference between imposing a race on other races or a language or a religion or an ideology.</s>
<s id="1:57">هەمووی هەر ڕەگەزپەرەستییە."(دوکتۆر موحسێن ڕەنانی - 1395)</s>	<s id="1:57">They are all racism (Dr. Mohsen Renani, 2016).</s>
<s id="1:58">لە کۆی 200 وڵاتی جیهان، ئێران لەو دەگمەن وڵاتانەیە کە خوێندن و فێربوونی زمانی دایکیی تێیدا ڕێگەپێنەدراوە.</s>	<s id="1:58">Among 200 countries, Iran is one of the few in which reading and learning in mother language is prohibited.</s>
<s id="1:59">دیارە لەبەرچاو نەگرتنی جیاوازییە زمانی و نەتەوەییەکان و سەپاندنی زمان و ئەدەبیات و فەرهەنگی یەک نەتەوە، خزمەت بە هەمان پرۆژە شکست خواردوەکەی "یەکدەست کردن"ی وڵاتە.</s>	<s id="1:59">It is clear that ignoring linguistic and national differences and imposing the language and literature of a nation is the service of the failed domination project.</s>
<s id="1:60">ئەو پرۆژە و ڕوانگە، تەنیا یەک زمانی لا گرێنگە و بایەخێکی ئەوتۆ بۆ زمانی دایکیی دەیان ملوێن مرۆڤی دیکە لە وڵاتێکی پان و بەرینی وەک ئێران دانانێت.</s>	<s id="1:60">This project only considers one language and does not recognize the language of millions of people in a large country like Iran.</s>
<s id="1:61">زمانەکانی کوردی، تورکی، عەرەبی، بەلوچی و تورکەمەنی وەکوو زمانی دایکیی نەتەوەکانی دیکەی ئێران، پیشاندەری لایەنێک لە فەرهەنگ و کەسایەتی جیاوازی ئەو نەتەوانەیە و لە هەمان کاتدا ئاوێنەی باڵانوێنی داب و نەریت و بیر و بڕوا و بایەخەکانیانە. ئەو بایەخ و کەسایەتیانە کە لە نەوەیەک بۆ نەوەیەکی تازە دەگوێزرێتەوە.</s>	<s id="1:61">Kurdish, Turkish, Arabic, Baluchi and Turkmen languages, like the native language of nations in Iran, represent the different culture and personality of these nations, as well as reflecting their thoughts, beliefs, and values transmitted from generation to another.</s>
<s id="1:62">بۆیە گومان لەوەدا نییە کە سەپاندنی سیستەمی خوێندن و فێرکاری فەرمی تەنیا بە یەک زمان، هێمایەکی ڕوونی زمان کوژییە کە دەبێتە هۆی لاواز بوونی پێگەی کۆمەڵایەتی زمانەکانی دیکەی ئێران و ئاڵۆز کردنی جەوهەر و ناوەرۆک و هەروەها دەوری گواستنەوەیان لە نەوەیەک بۆ نەوەکانی داهاتوو.</s>	<s id="1:62">Therefore, the imposition of a system of teaching and reading in just one language is an obvious execution of languages, which undermines the social status of other languages in Iran.</s>
<s id="1:63">21ی فوریەی هەموو ساڵێک، وەبیرهێنەری ڕۆژێکی زۆر گرینگی جیهانییە.</s>	<s id="1:63">Each year February 21 is a reminder of the mother language.</s>
<s id="1:64">لەم ڕۆژەدا سازمانی یۆنسکۆ لە هەنگاوێکی بێ وێنەدا، بە پێشنیاری فەرمی وڵاتی بنگلادش لە نوامبێری ساڵی 1999ی زایینی، ڕۆژی زمانی دایکیی بۆ هەموو وڵاتانی جیهان ڕاگەیاند.</s>	<s id="1:64">In 1999, the UNESCO announced in a clear step with an official offer from Bangladesh for February 21 to be titled as the International Mother Language Day.</s>
<s id="1:65">یۆنسکۆ هەروەها سیستەمی فێرکاری چەند زمانەی بۆ ئەو وڵاتانەی کە دانیشتوانی لە چەند زمان و چەند نەتەوەی جیاواز پێک هاتوە، پێشنیار کرد.</s>	<s id="1:65">The UNESCO also proposed a multi-lingual curriculum for countries that include several languages and different nations.</s>
<s id="1:66">ڕێکخراوە مەدەنییەکانی مەریوان، وێڕای پیرۆزبایی و بەرزڕاگرتنی ڕۆژی جیهانی زمانی دایکیی، لە سەر ئەو بڕوایەن کە بەفەرمی ناسینی زمانە جیاوازەکان و بەڕێوەبردنی سیستەمی فێرکاری چەند زمانە لە کۆمەڵگادا، هیچ ناتەباییەکی لە گەڵ پاراستنی یەکپارچەیی وڵات و بەهێزکردنی گیانی هاوپێوەندی نێوان دانیشتوانی ئێراندا نییە.</s>	<s id="1:66">As the civil organizations in Marivan, we believe that recognition of different languages and the creation of multilingual education system in society would not be in conflict with preserving the country's sovereignty and maintaining a link between the Iranian peoples.</s>
<s id="1:67">بەڵکوو بێبەشکردنی مرۆڤەکان لە فێرکاری و خوێندن بە زمانی دایکیی و ئەو هەست بە بەشخوراوییەیە کە ئەوان تووشی داڕمان و وێرانکاریی و دابڕان دەکات.</s>	<s id="1:67">On the contrary, depriving people of their education and learning of their mother tongue and violation of individual rights leads to destruction and division.</s>
<s id="1:68">کەوایە ئێمە؛ ڕێکخراوە مەدەنییەکانی مەریوان وەک ویژدانی هوشیار و نوێنەرانی ڕاستەقینەی فەرهەنگی و کۆمەڵایەتی ئەم نیشتمانە، بەوپەڕی پێداگریەوە خوازیاری دامەزراندنی سیستەمی چەند زمانە لە ئێرانداین و خوێندن و فێرکاری بە زمانی کوردی لە هەموو خوێندنگاکانی ناوچە کوردنشینەکانی ئێران لە باخچەی ساوایانەوە تا دوایین قۆناغی خوێندن.</s>	<s id="1:68">As the civil society organizations in Marivan, the true representative of the culture and community of this land, we are keen to establish a multilingual curriculum in Iran; teaching and reading Kurdish in all schools in the Kurdish regions of Iran, from kindergartens to the final stages of studying.</s>
<s id="1:69">بە پێویستیەکی بێ ئەم لاوئەولا دەزانین و نامانەوێت لەمە زیاتر سیاسەتی زمان کوژی و پێشێل کردنی مافە فەرهەنگی و کۆمەڵایەتیەکانمان درێژە بکێشێت.</s>	<s id="1:69">We consider it essential and we do not want this linguistic extermination policy and violation of our cultural and social rights to be continued.</s>
<s id="1:70">ئەنجومەنی فەرهەنگی - ئەدەبیی مەریوان</s>	<s id="1:70">Marivan Literary Society</s>
<s id="1:71">ئەنجومەنی فەرهەنگی - هونەری ڤەژین</s>	<s id="1:71">Vejîn Art and Cultural Association</s>
<s id="1:72">ناوەندی زانستی - فەرهەنگی ڕۆنان</s>	<s id="1:72">Ronan Scientific and Cultural Center</s>
<s id="1:73">ئەنجومەنی خەڵکیی بۆ بەرەنگاربوونەوەی مادە هۆشبەرەکان – ژیانەوە</s>	<s id="1:73">Jiyanewe Popular Union for Combating Drugs</s>
<s id="1:74">ئەنجومەنی سەوزی چیا</s>	<s id="1:74">Green Chia Society</s>
<s id="1:75">ئەنجومەنی فەرهەنگی – ئەدەبیی ڕۆجیار</s>	<s id="1:75">Rocyar Cultural Literary Community</s>
<s id="1:76">ئەنجومەنی نمایشی مەریوان</s>	<s id="1:76">Marivan Theatre Union</s>
<s id="1:77">یەکیەتی مامۆستایانی ئایینی مەریوان و هەورامان - یەمامە</s>	<s id="1:77">Religious Teachers Union in Hewraman</s>
<s id="1:78">ئەنجومەنی پیشەیی مەعەلمان(مامۆستایان) مەریوان</s>	<s id="1:78">Marivan School Teachers Union</s>
<s id="1:79">ئەنجومەنی سڵامەتی ژین</s>	<s id="1:79">Jîn Health Club</s>
<s id="1:80">فیلمی 'بۆ ئازادی' کە لەبارەی بەرخۆدانی سوور بەرهەمهێنراوە، لە ناوەندی کلتور و هونەری محەمەد شێخۆ لە قامشلۆ نمایشکرا.</s>	<s id="1:80">The film Ji Bo Azadiyê (The end will be spectacular) about the resistance of Sur was screened at Mihemed Şêxo Culture and Art Center in Qamishlo.</s>
<s id="1:81">کۆمۆنی فیلمی ڕۆژئاوا لە ناوەندی کلتور و هونەری محەمەد شێخۆ فیلمی 'بۆ ئازادی' نمایشکراد.</s>	<s id="1:81">Rojava Film Commune is organising special screening of the film ‘Ji Bo Azadiyê'.</s>
<s id="1:82">فیلمەکە کە لە لایەن ئەرسین چەلیکەوە بەرهەمهێنراوە لە کۆبانێ بەرهەم هاتووە.</s>	<s id="1:82">Directed by Ersin Çelik, the film was shot in Kobanê.</s>
<s id="1:83">150 دەزگای چاپ و پەخش بە دەیان هەزار کتێبەوە بەشدارییان لە پێشانگاکەدا کرد، بەڵام لە کاتی ناساندنی بەرپرسە داسەپێنراوەکانی ئاکەپە بەسەر شارەوانیی وان دا ڕایگەیاند، فرۆشتنی کتێب بە زمانی کرد لە پێشانگاکەدا قەدەغەیە.</s>	<s id="1:83">150 publishers are participating in the fair with tens of thousands of books, but municipal officials have banned the promotion and sale of books in Kurdish.</s>
<s id="1:84">لەشاری کاراسنۆدار-ی فیدراسیۆنی ڕووسیا کۆرسی زمانی کوردی بۆمندالان کرایەوە.</s>	<s id="1:84">A Kurdish language course has been started for children in the Russian city of Krasnodar.</s>
<s id="1:85">بنەماڵەکان خۆشحاڵی خۆیان بۆکردنەوەی کۆرسی زمانی کوردی دەربڕی، ئەم کۆرسە بەدەسپێشخەری ئۆتۆنۆمی چاندی کوردی لە کاراسنۆداردەستیپێکردووە.</s>	<s id="1:85">Kurdish families have shown a great interest in this language course opened under the lead of the Kurdish Cultural Autonomy in Krasnodar.</s>
<s id="1:86">ئیشخان ئانکۆسێ سەرەڕای تەمەنی زۆری خۆیی دەڵێت بۆئەوەی کە مندالانی کورد ئاسمیلە نەبن و بەزمانی دایکی خۆیان خزمەت بەگەلی کورد بکەن ئەم ئەرکەی گرتووەتە ئەستۆی خۆیی.</s>	<s id="1:86">Despite his old age, İşxan Ankosi says he has voluntarily joined the program in order to save the Kurdish children from assimilation and to help them serve their people in their own language.</s>
<s id="1:87">ئانکۆسێ وتی، لەڕووسیا بۆ خەباتی ئاوەها پێوەندی گەل زۆرە و باسی لەوەکرد ، " 20ساڵ پێش ئیستا کاتێک کە گەلی ئێمە کۆچبەری ڕووسیا بوون ئەمە پلانی سەرەکی ئێمە بوو."</s>	<s id="1:87">Ankosi remarked that people had more interest in such activities in Russia before, adding; “Twenty years ago, when our people migrated here, we had serious concerns about the future of our language and culture.”</s>
<s id="1:88">ئانکۆسێ دەربارەی گرینگی زمانی دایکی وتی،  کۆمەڵگە بەزمانی خۆی بوونی خۆی بەردەوام دەکات.</s>	<s id="1:88">Speaking on the importance of mother language, Ankosi said: Societies continue their existence with their languages.</s>
<s id="1:89">ئێمەش بەپەلە گەرەکمانە دەست بەم کارەبکەین وخەباتی خۆمان بەرفراوانتربکەین.</s>	<s id="1:89">Even it might be late, we intend to do this work and promote similar activities.</s>
<s id="1:90">هیوادارم لەم بوارەدا گەلەکەمان هاوکاری ئێمەبن و لەم ڕێگەیەدا یارمەتیمان بدەن.</s>	<s id="1:90">We hope that our people will support us in the program.</s>
<s id="1:91">مامۆستا ئانکۆسێ لەدرێژەدا وتی، لەپەروەردەی زماندا گەنجان هاوکات لەگەل فێربوونی زمان ، مێژوویی زمانی کوردی وکلتووری کوردیش دەناسن.</s>	<s id="1:91">Ankosi noted that along with the Kurdish language courses, the students will learn about the history of the Kurdish language and Kurdish culture.</s>
<s id="1:92">تێلمان کاچاخ و براکەی بەکرێ هاتنە سەر پۆلی زمانی کوردی، پێشتریش ئەم بنەماڵەیە دەستیان بەخەباتی زمانی کوردی کردبوو.</s>	<s id="1:92">Tilmanê Kaçax and Bekirê Kaçax are two Kurdish brothers who have voluntarily taken responsibility of the funding for the Kurdish course.</s>
<s id="1:93">ئێمە بەم زمانە هەڵبەستمان خویندووەتەوە و وتەی خۆشمان بیستووە.</s>	<s id="1:93">We read our first poem and voiced our first beautiful saying in Kurdish.</s>
<s id="1:94">پێوستی بە هاوکاری گەل هەیە.</s>	<s id="1:94">‘Need for support to the project.</s>
<s id="1:95">نورە ئاشێرێ کە خۆی مامۆستای زمانی کوردییە وتی، " بۆئەوەی کە لەدواڕۆژدا کاروخەباتەکەمان فراوانتربکەین پێویستمان بەهاوکاریگەل هەیە.</s>	<s id="1:95">Nûrê Aşîrî, one of the teachers in the course, said: In order to continue our cultural and linguistic activities, we will need the support of our people.</s>
<s id="1:96">بەبی هاوکاری گەل خەباتێکی لەم چەشنەدا سەرناکەوێت.</s>	<s id="1:96">Without their support, it would be impossible to succeed in such efforts.</s>
<s id="1:97">ناوەندی ڕاگەیاندن و چاپەمەنی یەپەگە لە ڕاگەیەنراوێکدا ناسنامەی 7 شەڕڤانی ئاشکرا کرد کە لە هەنگاوی ڕزگارکردنی منبج دا شەهید بوون.</s>	<s id="1:97">The YPG Press and Liaison Center issued a written statement about 7 fighters who fell martyrs in 2016.</s>
<s id="1:98">ڕاگەیەنراوی یەپەگە بەم شێوەیەیە:</s>	<s id="1:98">The YPG statement said.</s>
<s id="1:99">هێزەکانی ڕزگاری عەفرین- HREرایگەیاند، لە ئەنجامی چالاکیەکانیاندا 7 چەتەی دەوڵەتی داگیرکەری تورک لە عەفرین کوژراون و 19 چەتەی دیکەش بریندار بوون.</s>	<s id="1:99">7 jihadists were killed, 19 others wounded and a vehicle was destroyed as a result of HRE operations.</s>
<s id="1:100">هێزەکانی ڕزگاری عەفرین لە بارەی دوایین چالاکیەکانیان لە دژی هێزی داگیرکەران ڕاگەیێندراوێکی بڵاو کردەوە کە تێیدا هاتووە:</s>	<s id="1:100">Afrin Liberation Forces (HRE) announced the results of their latest operations against the occupation forces in northern Syria. Details of the HRE operations announced in a written statement are as follows;</s>
<s id="1:101">"16ی ئازار هێزەکانمان لە عەفرین لە دژی خاڵێکی پشکنینی سەر بە چەتەکان چالاکیەکیان ئەنجامدا. لە ئەنجامی چالاکیەکەدا 4 چەتە کوژران.</s>	<s id="1:101">On March 16, HRE fighters carried out a sabotage operation against Turkish-backed mercenaries at a checkpoint in Afrin, leaving 4 of them wounded.</s>
<s id="1:102">18ی ئازاریش هێزەکانمان لە ناوەندی شاری عەفرین زنجیرە چالاکیەکیان ئەنجامدا. لە ئەنجامی ئەو زنجیرە چالاکیانەشدا، 6 چەتە کوژران و 15 چەتەی تریش بریندار بوون.</s>	<s id="1:102">On March 18, operations by HRE fighters in Afrin city centre killed 6 jihadists and wounded 15 others.</s>
<s id="1:103">لە گوندی جەلەمی ناوچەی جندرێسیش هێزەکانمان لە دژی چەتەکانی، چالاکیەکیان ئەنجامدا, لە ئەنجامی ئەو چالاکیەکەشدا چەتەیەک کوژران و ئۆتۆمبیلێکی چەتەکانیش تێکشکێندرا.</s>	<s id="1:103">HRE fighters targeted the mercenaries in Celemê village of Jindires district, which left a mercenary dead and a vehicle destroyed.</s>
<s id="1:104">بە گشتی لە ئەنجامی چالاکیەکانی ئەو دوو ڕۆژەدا 7 چەتە کوژران و 19 چەتەی دیکەش بریندار بون.</s>	<s id="1:104">7 jihadists were killed, 19 others wounded and a vehicle was destroyed as a result of HRE operations.</s>
<s id="1:105">چەتەکانی دەوڵەتی داگیرکەر لە ژێر ناوی 'فیرقەی 112ی دەوڵەتی تورک لە گوندی بادینای سەر بەناوچەی ڕەجۆ هەر یەک لە مستەفا محمد ئیبیش، محمد خەلیل شەعبان و ئەحمەد عارف ئیبیشیان ڕفاند.</s>	<s id="1:105">Three of these civilians, Mustefa Mihemed İbiş, Mihemed Xelil Şaban and Ehmed Arif İbiş, were kidnapped from the village of Badina, Rajo by the so-called ‘Firqat 112’ group.</s>
<s id="1:106">چەتەکان هاوکات لە ژێر ناوی گروپی 'محمد فاتیح'ی سەر بە دەوڵەتی داگیرکەر لە گوندی بریمەجەی سەر بە ناوچەی مەعبەداش هەر یەک لە کامەران سبحی قاسمۆ و محمد عبدویان فریاند.</s>	<s id="1:106">Kamiran Sibhi Qasimo and Mihemed Ebdo, on the other hand, were kidnapped by the ‘Mehmet Fatih’ group from the village of Birimece, Mabata.</s>
<s id="1:107">ڕاگەیەنراوەکە بەم شێوەیەیە:</s>	<s id="1:107">The statement reads as follows:</s>
<s id="1:108">دەوڵەتی تورکی داگیرکەر و چەتەکانی شەوی ڕابردوو شوێن و ماڵ و حاڵی هاووڵاتییانی گرێ سپی یان بۆردومانکرد.</s>	<s id="1:108">The invading Turkish state and its gangs bombed civilian settlements in Girê Spî last night.</s>
<s id="1:109">دەوڵەتی تورکی داگیرکەر و چەتەکانی شەوی ڕابردوو گوندەکانی قزەلی و سلیپ و عەمبارەکانی گەنمی قزەلییان بۆردومانکرد، کە دەکەونە ڕۆژئاوای گرێ سپی.</s>	<s id="1:109">The invading Turkish state and its gangs bombed the villages of Qizelî and Silîp as well as Qizelî wheat warehouse in the west of Girê Spî with artillery shots.</s>
<s id="1:110">بەهۆی ئەو بۆردومانەوە ئاگر بەربوویە زەوییە کشتوکاڵییەکانی هاووڵاتییان لەو ناوچانەدا.</s>	<s id="1:110">In the attack, a fire broke out affecting people's houses and agricultural lands.</s>
<s id="1:111">سوپای تورکی داگیرکەر بە چڕی گوندەکانی عەفرین و تلتەمر بۆردومان دەکات.</s>	<s id="1:111">The invading Turkish army is heavily bombing villages of Afrin and Til Temir.</s>
<s id="1:112">سوپای تورکی داگیرکەر و گروپە چەتەکانی گوندی ئوم ئەل کێف لە تلتەمر و گوندەکانی بێنێ و عاقبێ لە ناوچەی شێراوای عەفرین بۆردومان دەکەن.</s>	<s id="1:112">The invading Turkish state and its mercenaries are bombing the village of Um El Kêf in Til Temir and the villages of Bênê and Aqibê in Shêrawa (Afrin).</s>
<s id="1:113">هێزەکانی ڕزگاری عەفرین- HREرایگەیاند، هیزەکانیان لە ناوچەی شێرەوا و باب هێزێکی کوشتندەیان لە چەتەی داگیرکەران داوە و بە پێی زانیاریەکانیان چەتەیەک کوژراوە و 5 چەتەی دیکەش بریندار بوون.</s>	<s id="1:113">Afrin Liberation Forces (HRE) announced that at least one jihadist was killed and another five wounded as result of their operations.</s>
<s id="1:114">لە 2ی نیساندا لە نزیک گوندی بەرادی سەر بە ناوچەی شێراوا هیزەکانمان لە دژی چەتەی داگیرکەران چالاکیەکیان ئەنجامدا. لەو چالاکیەدا چەتەیەک کوژرا و 3 چەتەی دیکەش بریندار بوون.</s>	<s id="1:114">On April 2nd, HRE fighters hit the jihadists in Beradê village of Sherawa, leaving one mercenary dead and three others wounded.</s>
<s id="1:115">لە 12ی نیسانیشدا هێزەکانمان لە ناوەندی شاری باب لە دژی چەتەکان چالاکیەکیان ئەنجامدا. لەو چالاکیەشدا 2 چەتە بریندار بوون.</s>	<s id="1:115">On April 12th, HRE targeted the mercenaries in al-Bab city center, which left two jihadists wounded.</s>
<s id="1:116">ناسنامەی شەهیدانمان بەم شێوەیەیە:</s>	<s id="1:116">ID details of the three HRE fighters are as follows:</s>
<s id="1:117">هێزەکانی ڕزگاری عەفرین (HRE) لە شێراوا، عەفرین و عەزاز لە هێزەکانی داگیرکەری تورکیاندا و لە ئەنجامی چالاکیەکاندا 6 سەربازی کوژران و 5 سەربازیش برینداربوون.</s>	<s id="1:117">The Afrin Liberation Forces (HRE) reported that at least 6 invaders were killed and 5 injured in the actions they carried out against the invading Turkish forces and mercenaries in Shêrawa, Afrin and Azaz.</s>
<s id="1:118">هێزەکانی ڕزگاری عەفرین ڕایگەیاند، چالاکیەکان لەنێوان 15 و 18 مانگدا ئەنجامدراون و لە شێراوا 2، لە عەزاز یەک و لە عەفرینیش 3 چەتە کوژراون.</s>	<s id="1:118">The Afrin Liberation Forces (HRE) stated that the actions took place between 15-18 April. According to the statement issued, two mercenaries were killed in Shêrawa, 1 in Azaz and 3 in Afrin.</s>
<s id="1:119">ڕاگەیەنراوی هێزەکانی ڕزگاری عەفرین بەم شێوەیەیە:</s>	<s id="1:119">The HRE's statement said:</s>
<s id="1:120">ڕۆژی 15ی نیسان لە نزیک گوندی کەفەر نەبۆ سەر بە ناوچەی شێراوا لەدژی چەتەکانی سوپای داگیرکەر چالاکی ئەنجامدرا. لە ئەنجامی چالاکیەکەدا 2 چەتە کوژران و 2 چەتەش بریندار بوون.</s>	<s id="1:120">On 15 April, our forces carried out a sabotage action against mercenaries affiliated to the invading Turkish army in the village of Kefer Nebo in Shêrawa. As a result of the action, 2 mercenaries died and 2 were injured.</s>
<s id="1:121">18ی نیسان هێزەکانمان لە چواریانی وەتەنی لە ناوەندی شاری عەفرین لە چەتەکانیاندا و لە ئەنجامدا 3 جەتە کوژران و 3 چەتەش برینداربوون.</s>	<s id="1:121">18 April: Our forces carried out a sabotage action against the invading army mercenaries at the Wetani junction in the center of the city of Afrin. In this action, 3 mercenaries were killed and 3 injured.</s>
<s id="1:122">ئیسرائیل لە ساڵی 2011ەوە و لە دوای دەستپێکردنی شەڕی ناوخۆیی لە سوریا، چەندین جار هێرشی کردووەتە سەر هێزەکانی ڕژێمی سوریا و هاوپەیمانەکانی ئەو ڕژێمە لە سوریا، کە ئەوانیش ئێران و حیزبوڵان.</s>	<s id="1:122">Israel has carried out numerous attacks allegedly against Iran and Hezbollah, which have sided with Damascus since 2011, when the civil war began in Syria.</s>
<s id="1:123">بەپێی سەرچاوەکانی ڕژێمی سوریا، ئیسرائیل لە 20ی نیساندا دەشتەکانی پالیمرای بۆردومانکردووە.</s>	<s id="1:123">On April 20, according to regime sources, some targets in the Palmira desert were bombed by Israel.</s>
<s id="1:124">رێکخراوی مافەکانی مرۆڤ لە سوریا ڕایگەیاند، هێرشەکە بۆ سەر ئەو شوێنانە بووە، کە ملیشیا ئێرانییەکانی تیادا بووە و بەو هۆیەوە 3 چەکداری سوری و 6 چەکداری بیانی کوژراون. </s>	<s id="1:124">The Syrian Human Rights Observatory reported that the posts of the Iranian militia were targeted in the attack, 3 Syrian fighters and 6 foreign fighters were killed.</s>
<s id="1:125">دەوڵەتی داگیرکەری تورک لەگەڵ ئەوەی ڤایرۆسی کۆرۆنا لە هەموو جیهاندا بڵاوبووەتەوە و مەترسی لەسەر مرۆڤایەتی دروست کردووە، بێوەستان هێرش دەکاتە سەر باکوور و ڕۆژهەڵاتی سوریا.</s>	<s id="1:125">Now they continued to be exposed to the attacks of the Turkish state as well as to the coronavirus pandemic threat.</s>
<s id="1:126">عەڤدۆ بەرەکات یاریدەدەری هاوسەرۆکی ئەنجومەنی شێراوا ڕایگەیاند، ئەوان لە لایەک گەل لە مەترسی کۆرۆنا دەپارێزن..</s>	<s id="1:126">The co-chair of the Sherewa Council, Evdo Berakat, said that they are trying to take measures to protect the people against the danger posed by the coronavirus infection.</s>
<s id="1:127">نە نەخۆشخانەمان هەیە نە دکتور.</s>	<s id="1:127">We have neither hospital nor doctors.</s>
<s id="1:128">ئەگەر ڤایرۆسەکە بگاتە ئێرە ئەنجامەکەی قوڕس دەبێت.</s>	<s id="1:128">If the coronavirus outbreak reaches us, the consequences will be devastating.</s>
<s id="1:129">پێویستە ڕێگری لە ئەردۆغان بکرێت.</s>	<s id="1:129">Someone should say stop to Erdogan.</s>
<s id="1:130">ئێمە 14 خانەوادەین.</s>	<s id="1:130">We are 14 families.</s>
<s id="1:131">دەوڵەتی تورک هەموو ڕۆژێک بە هاوەن هێرش دەکات.</s>	<s id="1:131">And, the Turkish state is attacking with mortars.</s>
<s id="1:132">ئێمە نازانم لەبەرانبەر ئەو هێرشانە چیبکەین.</s>	<s id="1:132">We no longer know what to do against these attacks.</s>
<s id="1:133">سەمار عەبدولا هاوسەرۆکی ئەنجومەنی کانتۆنی حەسەکە ڕایگەیاند، دەوڵەتی تورک ملیۆنەک کەسی بێئاو هێشتووەتەوە، بەو شێوەیە پێداویستیە سەرەکیەکان وەک چەکێک بەکاردەهێنێت و تاوانی مرۆڤایەتی ئەنجامدەدات.</s>	<s id="1:133">Semar Ebdullah, co-chair of the Hesekê Canton Council, said that the Turkish state, which left one million people without water, has committed a crime against humanity by using basic needs as a weapon.</s>
<s id="1:134">لە هەرێمەکانی باکوور و ڕۆژهەڵاتی سوریا قەدەغەی هاتوچۆ لە 23ی ئازارەوە بە هۆی پەتای ڤایرۆسی کۆرۆناوە بەردەوامە.</s>	<s id="1:134">The curfew, which was announced on 23 March due to the coronavirus epidemic, continues in the northern and eastern Syria regions.</s>
<s id="1:135">بە پێی سەرچاوەکانی بەڕێوەبەرایەتی خۆسەر 80%ی گەل پابەندی ڕێنماییەکان بۆ قەدەغەکردنی هاتوچۆ بووە و لە ماڵەوە ناچنە دەرەوە.</s>	<s id="1:135">According to the Autonomous Administration sources, 80 percent of the local people do not leave their homes, following the curfew.</s>
<s id="1:136">لە هەرێمەکە ڕێوشوێنەکانیش بۆ بەرەنگاربوونەوەی ڤایرۆسەکە زیاد دەکرێن.</s>	<s id="1:136">The measures taken in the region due to the virus are also being increased.</s>
<s id="1:137">سەمرا عەبدولا داوای لە گەلانی هەرێمەکانی کانتۆنی حەسەکە (شەداد، هۆل، حەسەکە، تەل تەمر، عاموودێ و دربێسی) کرد بە پێی بڕیارەکانی بەڕێوەبەرایەتی خۆسەر بجووڵێنەوە.</s>	<s id="1:137">Ebdullah called on the people living in the regions of the Hesekê Canton (Şedade, Hall, Hesêkê, Til Temir, Amûdê, Dirbesiyê) to comply with the decisions taken by the Autonomous Administration.</s>
<s id="1:138">سەمار عەبدولا ڕاشیگەیاند، بەهۆی گرتنەوەی ئاوەوە ڕێوشوێنەکانی لەدژی ڤایرۆسی کۆرۆنا لاواز بووە و وتی، "دەوڵەتی تورک بە گرتنەوەی ئاوەوە تاوانی مرۆڤایەتی ئەنجام دەدات.</s>	<s id="1:138">Ebdullah accused the Turkish state and its mercenaries to have committed a crime against humanity by leaving the people without water.</s>
<s id="1:139">مانگی سووری کورد بۆ چارەسەرکردنی ئەو کەسانەی تووشی ڤایرۆسی کۆرۆنای نوێ دەبن لە شاری حەسەکە نەخۆشخانەیەکی 120 قەڕەوێلەیی کردەوە.</s>	<s id="1:139">Heyva Sor a Kurd has established a 120-bed capacity hospital in Hesekê to fight the coronavirus pandemic.</s>
<s id="1:140">لە ناوچەی کەمالیەی سەر بە شاری ئەرزینجان بە گوڕی 4.0 پلەی ڕیختەر بومەلەرزەیەک ڕوویدا.</s>	<s id="1:140">A 4.0 magnitude earthquake occurred in Kemaliye, Erzincan.</s>
<s id="1:141">بومەلەرزەکە لە کاتژمێر 18:41 خولەکی ئەم ئێوارەیە ڕوویداوە کە ناوەندەکەی ناوچەی کەمالیەی شاری ئەرزینجان بووە و گوڕەکەشی 4.0 پلەی ڕیختەر بووە.</s>	<s id="1:141">Kandilli Observatory announced that a 4.0 magnitude earthquake occurred at 6.41 pm in Kemaliye, province of Erzincan.</s>
<s id="1:142">بزوتنەوەی گەنجانی شۆرشگێر لەدژی هێرشی داگیرکەری تورک و نۆکەرایەتی لە شاری مارسیلیای فەڕەنسا چالاکیان ئەنجامدا.</s>	<s id="1:142">The Kurdish Revolutionary Youth Movement carried out two separate actions in Marseille to protest the Turkish occupation attacks.</s>
<s id="1:143">هەمان ڕۆژ چالاکیەکی تر لە هەرێمی ماریگان ئەنجامدرا.</s>	<s id="1:143">A second action was held in the Marignane region.</s>
<s id="1:144">گەنجان پانکارتی 'فەدەنف مەخمور'یان بە پرسێکەوە هەڵواسی و هێرشی دەوڵەتی فاشیستی تورکیان بۆ سەر باشووری کوردستان شەرمەزار کرد.</s>	<s id="1:144">Young people here hung a banner with the words "Defend Maxmur" on an overpass and drew attention to the attacks of the fascist Turkish state in South Kurdistan.</s>
<s id="1:145">عەلی کۆنار برای عومەر خەیری کۆنار، پۆڵات یڵدرم برای حامیلی یڵدرم، مەلیحە چەتین خوشکی وەیسی ئاکتاش لە ڕێگەی پارێزەرانەوە سەردانیان کرد.</s>	<s id="1:145">Ömer Hayri Konar’s brother Ali Konar, Hamili Yıldırım's brother Polat Yıldırım and Veysi Aktaş' sister Melihe Çetin also applied to the prosecutor's office through their lawyers.</s>
<s id="1:146">گەنجان لە شاری شتوتگارتی ئەڵمانیا گۆشەگیری سەر عەبدوڵلا ئۆجالان ڕێبەری گەلی کوردیان شەرمەزار کرد.</s>	<s id="1:146">Young people in Stuttgart protested the isolation against Kurdish people's leader Abdullah Öcalan.</s>
<s id="1:147">چالاکی گەنجان بۆ شەرمەزارکردنی گۆشەگیری سەر عەبدوڵلا ئۆجالان ڕێبەری گەلی کورد و ئازادی ئەو لە ئەوروپا بەردەوامە.</s>	<s id="1:147">The actions of Kurdish youth in Europe continue to protest the isolation imposed by the Turkish state against Kurdish people's leader Abdullah Öcalan.</s>
<s id="1:148">گەنجان بە ئەڵمانی، کورد و تورکی دروشمی 'ئازادی بۆ ئۆجالان'، 'بێ سەرۆک ژیان نابێت'، 'تۆڵەکردنەوە' و 'بژی ئۆجالانیان' وتەوە.</s>	<s id="1:148">Young people shouted slogans like "Freedom for Öcalan", "Bê Serok Jiyan Nabe", "Revenge" and "Long Live Öcalan" in German, Kurdish and Turkish.</s>
<s id="1:149">پێویستە لە میزۆپۆتامیادا ئەو دەوڵەتانەی لە سەرەوەن مافی بەدەستهێنانی ئاوی وەڵاتانی خوارەوە پەسەند بکەن.</s>	<s id="1:149">Upstream states in Mesopotamia must ensure the rights of people downstream to water.</s>
<s id="1:150">پارتی دیموکراتی گەلان - هەدەپە</s>	<s id="1:150">Peoples’ Democratic Party (HDP)</s>
<s id="1:151">پارتی هەرێمە دیموکراتییەکان - دەبەپە</s>	<s id="1:151">Democratic Regions Party (DBP)</s>
<s id="1:152">پارتی سۆسیالیستی چەوساوەکان - ئەسەپە</s>	<s id="1:152">Socialist Party of the Oppressed (ESP)</s>
<s id="1:153">پارتی گەلی کۆماری - جەهەپە</s>	<s id="1:153">Republican People’s Party (CHP)</s>
<s id="1:154">کۆمەڵەی 78</s>	<s id="1:154">‘78s Association</s>
<s id="1:155">دایکانی ئاشتی</s>	<s id="1:155">Peace Mothers</s>
<s id="1:156">پلاتفۆڕمی ژنانی دیجلە ئامەد</s>	<s id="1:156">Dicle Amed Women Platform (DAKAP)</s>
<s id="1:157">نازناو: تێکۆشەر گەڤەر</s>	<s id="1:157">Code Name: Tekoşer Gever</s>
<s id="1:158">ناو و پاشناو: موسلح ئیکە</s>	<s id="1:158">Name Surname: Müslih İke</s>
<s id="1:159">شوێنی لە دایکبوون: جۆلەمێرگ</s>	<s id="1:159">Place of Birth: Hakkari</s>
<s id="1:160">ناوی دایک و باوک: مەحبوبە – ئەحمەد</s>	<s id="1:160">Mother - Father Name: Mahbup - Ahmet</s>
<s id="1:161">کات و شوێنی شەهید بوون: 20ی ئابی 2019 / هەرێمەکانی پاراستنی مەدیا</s>	<s id="1:161">Date and Place of Martyrdom: 20 August 2019 / Medya Defense Areas</s>
<s id="1:162">هەڤاڵمان تێکۆشەر لە ساڵی 1993 بەشداری ڕێزەکانی تێکۆشانی ئازادیی کوردستان بووە و ماوەیەکی دوور و درێژ لە گۆڕەپانەکانی شەڕدا تێکۆشاوە.</s>	<s id="1:162">Comrade Tekoşer joined in the Kurdistan Freedom Struggle in 1993 at a young age and worked with active devotion on the war field for many years.</s>
<s id="1:163">کۆڤید19 لە ئەوروپا و هەموو شوێنێکی جیهان بڵاوبووەتەوە.</s>	<s id="1:163">The Covid-19 pandemic has spread around the world.</s>
<s id="1:164">تا ئێستا لە بارەی زیانەکانەوە هیچ زانیاریەک بڵاو نەکراوەتەوە.</s>	<s id="1:164">There was no information available as to the damages after the earthquake.</s>
<s id="1:165">سوپای کۆماری تورکیای داگیرکەر لە 15ی نیساندا لە ئەرموشی ناوچەی خواکورک لە هەرێمەکانی پاراستنی مەدیا دەستی بە ئۆپراسیۆنکرد.</s>	<s id="1:165">According to the statement, the Turkish army launched an operation on April 15 in Xakurke region of Medya Defense Zones in southern Kurdistan, northern Iraq.</s>
<s id="1:166">فڕۆکە جەنگییەکانی سوپاری کۆماری تورکیای داگیرکەر ڕۆژی 14ی نیسان دەورووبەری گوندی چەکانکێ-یان لە ناوچەی گارەی سەر بە هەرێمەکانی پاراستنی مەدیا بۆردومانکرد.</s>	<s id="1:166">The Turkish jets shelled the vicinity of the Chemanke village in Gare region of Medya Defense Zones on April 14.</s>
<s id="1:167">لەو بۆردومانەدا هیچ زیانێک بە هێزەکانمان نەگەیشتووە، بەڵام زیان بە باخ و باخچە و ڕەزی هاووڵاتییانی ناوچەکە گەیشتووە.</s>	<s id="1:167">The air strikes did not cause any casualties in guerrilla ranks, but there was massive material damage to the civilian population's farmland.</s>
<s id="1:168">هێزەکانمان ڕۆژی 1ی نیسان لە سەر ڕێگای گوندی برج حەیدەر لە ناوچەی شێراوا لە دژی ئۆتۆمبێلی سەرەک چەتە بە ناوی ئەبو خالید چالاکییەکی سابوتاژیان ئەنجامدا.</s>	<s id="1:168">On April 1, HRE carried out a sabotage operation against the vehicle of jihadist leader Abu Khalid in the village of Birç Heyder in Sherawa.</s>
<s id="1:169">لەو چالاکییەدا ئەبو خالیدی سەرەک چەتە و 2 چەتەی تر کوژران و چەتەیەکی تریش بریندار بوو و ئۆتۆمبێلەکەشیان تێکشکێنرا.</s>	<s id="1:169">Khalid and two other jihadists were killed and the vehicle was completely destroyed.</s>
<s id="1:170">مەزلوم عەبدی فەرماندەی گشتی قەسەدە لە بارەی ڤایرۆسی کۆرۆناوە پەیامێکی بڵاو کردەوە و وتی:"لەم قۆناغە هەستیارەدا ئێمە دەڵێین، کارمەندانی تەندروستی، فەرماندەکانی ئێمەن."</s>	<s id="1:170">SDF Commander General Mazloum Abdi calls in a video message for the measures against the spread of the coronavirus adopted by the autonomous administration in northeast Syria to be followed.</s>
<s id="1:171">دکتور جوان مستەفا هاوسەرۆکی کۆمیتەی تەندروستی باکوور و ڕۆژهەڵاتی سوریا ڕایگەیاند، بەگۆمانی بڵاوبوونەوەی ڤایرۆسی کۆرۆنا کە لەسەر سەربازێکی هێزەکانی سوریا ئاشکرا بووە، گوندی ئوم ئەلهۆشی شەهبایان خستووەتە کەرەنتینەوە.</s>	<s id="1:171">The village of Um al-Hosh in the northern Syrian canton of Shehba has been quarantined, reported the co-chair of the Health Committee of Northern and Eastern Syria, Dr. Ciwan Mustafa.</s>
<s id="1:172">هێزەکانی ئاسایشی ناوخۆیی دەستیان بە ئۆپەڕاسیۆن کرد.</s>	<s id="1:172">Internal Security Forces launched an operation.</s>
<s id="1:173">بە پێی زانیاریەکان، شەی پێنجشەمە لەسەر هەینی کاتژمێر 01:00 ژمارەی کەسی نەناسراو دوو بۆمبیان خستە ماڵێکەوە.</s>	<s id="1:173">According to the information received, two hand grenades were thrown at a civilian house by unidentified person(s) at around 1 am on Friday.</s>
<s id="1:174">لە ڕووداوەکەدا زیان بەر کەس نەکەوت.</s>	<s id="1:174">There was no loss of life in the attack.</s>
<s id="1:175">هەمان شەو 2 ئۆتۆمبێڵی حکومەتی سوریا لە لایەن ژمارەیەک کەسی نەناسراوەوە سووتێنران.</s>	<s id="1:175">At the same night, two vehicles belonging to the Syrian government forces were set on fire by an unidentified person or persons.</s>
<s id="1:176">نازانرێت پەیوەندی هەردوو هێرشەکە پێکەوە هەیە یان نا.</s>	<s id="1:176">It is not known whether the two attacks are connected.</s>
<s id="1:177">هێزەکانی ئاسایشی ناوخۆیی دوای هێرشەکان دەستیان بە ئۆپەڕاسیۆن کردووە.</s>	<s id="1:177">Internal Security Forces launched an operation following the attacks.</s>
<s id="1:178">دوای ئەوەی چەتەکانی داعش لەمدواییانەدا لە ڕەقا هەندێک هێرشیان ئەنجامدا، هێزە سەربازییەکان ڕێوشوێنێ پێویستیان گرتەبەر و لە دژی شانەکانی داعش ئۆپراسیۆنەکانیان زیاتر کردووە.</s>	<s id="1:178">After ISIS cells had carried out a series of attacks in Raqqa recently, military forces increased security measures against the mercenaries in the region.</s>
<s id="1:179">لە چالاکیەکەدا دوو چەتە کوژران و 3 چەتەش بریندابوون.</s>	<s id="1:179">Two jihadists were killed and another three wounded in the sabotage action.</s>
<s id="1:180">بڕیار وایە شاندێکی ڕوسی لە ئەنکەرە چەندین چاوپێکەوتن ئەنجام بدات و بەر لە ئەنجامدانی چاوپێکەوتنەکانیش چەتەکانی دەوڵەتی تورک بریاریان داوە لە ڕێگای نێودەوڵەتی M5 بکشێنەوە.</s>	<s id="1:180">In the run-up to a visit by a Russian delegation to Ankara today, the Turkish-backed jihadists are said to have decided to withdraw from the M5 motorway between Idlib and Aleppo.</s>
<s id="1:181">دوای ئەوەی هێزەکانی ڕژێمی سوریا بە پشتیوانی ئاسمانی و زەمینیی ڕوسیا، شارۆچکەی سەراقیبی ئیدلبیان وەرگرتەوە، زانیاریی ئەوە بڵاو بووەوە کە ژمارەیەک لە گروپە چەتەکان لە ڕێگای M5 و چەند ناوچەیەکی دیکە کشاونەتەوە.</s>	<s id="1:181">After the Syrian army took Saraqeb in the south of Idlib with Russian air and ground support, the militias supported by Turkey are said to have decided to withdraw from some areas along the M5 road.</s>
<s id="1:182">لە ئەنجامی تۆپبارانەکەدا، لە گوندی ئاقیبەی سەر بە ناوچەی شێراوا هاوڵاتییەکی مەدەنی بە ناوی عەلی مەنلە ئەبو شابۆ-ی 65 ساڵ، گیانی لەدەستدا.</s>	<s id="1:182">The attacks killed a 65-year-old civilian named Elî Menle Ebû Şabo in the village of Aqiba in Afrin’s Sherawa district.</s>
<s id="1:183">هاوڕێکەمان عەفرین لە 21ی ئازاری 2020 دا لە قۆناغی دووەمی بەرخۆدانی عەفریندا برینداربوو، بەڵام لەگەڵ هەموو هەوڵێک و دەستوەردانێک بەهۆی سەختی برینەکەیەوە لە 31ی ئازاری 2020 شەهید بوو.</s>	<s id="1:183">Afrin Liberation Forces (HRE) fighter Xalid Elo (Efrîn) was injured in resistance against the Turkish occupation on March 21 and died of his injuries on March 31.</s>
<s id="1:184">هاوڕێ عەفرین لەناو خانەوادەیەکی وڵاتپاریز لە شاری عەفرین لەدایکبوو.</s>	<s id="1:184">Our comrade Efrîn was born in Afrin into a patriotic family.</s>
<s id="1:185">دوای داگیرکردنی عەفرین لە لایەن سوپای داگیرکەری تورکیا و چەتەکانیەوە، بەشداری لە ڕێزەکانی بەرخۆدان لەدژی داگیرکەری کرد.</s>	<s id="1:185">Under the impression of the resistance against the occupation of Afrin by the Turkish army and its gangs, he joined our ranks.</s>
<s id="1:186">لەبەرانبەر داگیرکەری عەفرین، تۆڕەیی و قینێکی گەورەی لەدڵدابوو و تا هەناسەی کۆتایی خۆی بە بوێریەکی گەورەوە تێکۆشانی کرد.</s>	<s id="1:186">He fought against the occupation with great anger and showed exemplary courage until his last breath.</s>
<s id="1:187">نازناو: عەفرین</s>	<s id="1:187">Nom de Guerre: Efrîn</s>
<s id="1:188">ناو و پاشناو: خالید عەلۆ</s>	<s id="1:188">First and Last name: Xalid Elo</s>
<s id="1:189">ناوی دایک: مەریەم</s>	<s id="1:189">Mother’s Name: Meryem</s>
<s id="1:190">ناوی باوک: عەلی</s>	<s id="1:190">Father’s Name: Elî</s>
<s id="1:191">شوێنی لەدایکبوون: عەفرین</s>	<s id="1:191">Place of Birth: Afrin</s>
<s id="1:192">شوێن و مێژووی شەهادەت: قۆناغی دووەمی بەرخۆدانی عەفرین / 31ی ئازاری 2020</s>	<s id="1:192">Place and Date of Martyrdom: Second stage of the Afrin resistance / 31 March 2020</s>
<s id="1:193">کۆمەڵگای ئازاد کە لە ئەڵمانیا بۆ کوردان کاری ڕای گشتی دەکات، لەبارەی گەمارۆی 10 مانگی سەر کەمپی پەنابەران مەخموور سبەینێ ئێوارە لەسەر ئینتەرنێت پانێلێک ڕێکدەخات.</s>	<s id="1:193">Civaka Azad, which is working for Kurds in Germany, will organize an online panel on Thursday regarding the embargo imposed on Maxmur Refugee Camp for over 10 months.</s>
<s id="1:194">دوای ئەوەی 17ی تەموزی 2019 لە شاری هەولێری باشووری کوردستان بەرپرسێکی میت بە ناوی عوسمان کوسە کوژرا، پەدەکە ئەو ڕووداوەی بەکارهێنا و گەمارۆی لەسەر کەمپی پەنابەرانی مەخموور دانا.</s>	<s id="1:194">Following the murder of MIT official Osman Köse in Hewlêr, South Kurdistan, on 17 July 2019, the KDP imposed an embargo on Maxmur Refugee Camp using this incident as a pretext.</s>
<s id="1:195">هەروەها بەرپرسانی کەمپی مەخموور بە شێوەیەکی ڕاستەوخۆ بەشداری لە پانێلەکەدا دەکەن و زانیاری لەبارەی دۆخی کەمپەکە دەخەنەڕوو.</s>	<s id="1:195">In addition, camp officials from Maxmûr will participate in the panel live and provide information about the latest situation.</s>
<s id="1:196">پانێل 7ی ئایار کاتژمێر 19:00 دەستپیدەکات و هەموو کەسێک دەتوانێت لە ڕێگەی ئەم لینکەی خوارەوە، تەماشای پانێلەکە بکات. https://civaka-azad.org/mexmur</s>	<s id="1:196">The meeting will begin at 7 pm on Thursday 7 May and can be followed at this address: https://civaka-azad.org/mexmur/</s>
<s id="1:197">تەرمی ئەندامی گروپی یۆروم ئیبراهیم گۆکچەک کە دوای 323 ڕۆژ لە مانگرتن و دوو ڕۆژ لە کۆتاییهێنان بە مانگرتنەکە شەهید بوو، لە پزیشکی دادوەری ڕادەگیرا، شەوی ڕابردوو لەگەڵ پۆلیس بۆ گۆڕستانی گوسولهانەسی گواسترایەوە.</s>	<s id="1:197">The body of Grup Yorum member Ibrahim Gökçek, who died two days after calling off the death fast he had carried on for 323 days, was brought to Kayseri for the funeral cemetery accompanied by the police at night.</s>
<s id="1:198">لە 5ی نیسان لە گەڕەکی مالیک ئەحمەد لە ناوچەی سووری ئامەد دەست شوێنی فرۆشیارانی ماددە هۆشبەرەکان وەردرا.</s>	<s id="1:198">On 5 April drug dealers were attacked in Amed Sur Melikahmet.</s>
<s id="1:199">لە ئەنجامدا لە شوێنی فرۆشتنی ماددە هۆشبەرەکان لە ناو برا.</s>	<s id="1:199">The house where drugs were sold was attacked and made unusable.</s>
<s id="1:200">لە 5ی نیسان لە گەڕەکی فیسکایا لە ناوچەی یەنیشەهیری ئامەد لە دژی پۆلیسەکانی تورک بە تەقەمەنی چالاکی ئەنجامدرا و دوژمن گورزی بەرکەوت.</s>	<s id="1:200">On 5 April, Turkish police officers patrolled in the Fiskaya neighborhood of Amed's Yenişehir district were attacked with handmade explosives, and the enemy was hit in the action.</s>
<s id="1:201">لە 12 و 15ی نیسان لە ناوچەی کارتاڵی ئیستەنبول 5 ئۆتۆمبێلی فاشیستەکان سوتێنران.</s>	<s id="1:201">On 12 and 15 April, 5 vehicles belonging to fascists were burned and destroyed in Kartal district of Istanbul.</s>
<s id="1:202">لە 19ی نیسان لە دژی هێرشەکانی سەر مەخمور و زینی وەرتێ و لە چوارچێوەی خۆپاراستندا لە گەڕەکی خاچۆرت لە ناوچەی ڕێیا ئارموش لە وان کاری پڕوپاگەندەیی ئەنجامدرا. هەروەها بە چەک و تەقەمەنی دەستوەردانیان لە یەکەی دوژمن کرد و لە ئەنجامدا دوژمن ناچار بوو خۆی بکشێنێتەوە.</s>	<s id="1:202">On 19 April our self-defense revenge units protested against the attacks on Maxm and Zînî Wertê in Van İpekyolu Xaçort, blocking the streets. The invading enemy police officers who came to the area were shot at and withdrew .</s>
<s id="1:203">یەکەکەمان تاوەکو بەرەبەیان ئاسایشی گەڕەکەیان پاراست.</s>	<s id="1:203">Our units provided security in the neighborhood until morning.</s>
<s id="1:204">لە 23ی نیسان لە ئارناڤۆت کۆی پاسێک و تاکسییەکی بازرگانیی هاوکارەکانی ئاکەپە سوتێنران.</s>	<s id="1:204">On 23 April, in Arnavutköy, a bus belonging to AKP collaborator was burned and a commercial taxi was destroyed.</s>
<s id="1:205">لە 24ی نیسان لە ئەسەنلەر 3 ئۆتۆمبێلی هاوکاری فاشیستەکان سوتێنران.</s>	<s id="1:205">On 24 April three vehicles belonging to fascist collaborators were burned down in Esenler.</s>
<s id="1:206">لە 27ی نیسان لە باشاکشەهیر ئۆتۆمبێلێکی ئەندامی ئەنجوومەنی ئاکەپەی فاشیست سوتێنرا.</s>	<s id="1:206">On 27 April, the vehicle of a fascist AKP council member was burned in Başakşehir.</s>
<s id="1:207">ئەنجوومەنی نێونەتەوەیی مافەکانی مرۆڤ (IGFM) بۆ ئازادکردنی گولسەر یڵدرم سیاسەتمەداری کورد نامەیەکی بۆ ئەردۆغان نارد.</s>	<s id="1:207">The International Society for Human Rights (IGFM) has asked Turkish President Erdogan to release Kurdish politician Gülser Yildirim.</s>
<s id="1:208">2ی ئایار سوپای داگیرکەری تورک لە ناوچەی دەری خەندەک، دەری ورچ و قەسابخانەی سەر بە هەرێمی جودی لە شرنەخ دەستی بە ئۆپڕاسیۆن کرد.</s>	<s id="1:208">On May 2, the Turkish army launched a military operation on Mount Cudi in Şırnak countryside which covered the areas of Deriyê Xendekê, Deriyê Hirçê and Kasaphane.</s>
<s id="1:209">ئۆپڕاسیۆنەکە لە 5ی ئایاردا بێئەنجام کۆتایی پێهات.</s>	<s id="1:209">The operation was ended without any results on May 5.</s>
<s id="1:210">5ی ئایار لە کاتژمێر 14:40 خولەک هێزەکانمان لە دژی قەرەقۆلی سوپای داگیرکەری تورک چالاکیەکیان ئەنجامدا کە دەکەوێتە نێون هەر دوو ناوچەی دادەر و سوارۆی سەر بە چیای جودی لە شرنەخ.</s>	<s id="1:210">On May 5, guerrillas targeted a military post located between the areas of Dader and Siwaro in the region of Mount Cudi.</s>
<s id="1:211">هەمان ڕۆژ هێزەکانمان لە دەوروبەری گوندی ئۆسیانی سەر بە هەرێمی بەستای شرنەخ لە دژی سوپای داگیرکەری تورک لە سەر گردێک چالاکیەکیان ئەنجامدا.</s>	<s id="1:211">On the same day, the HPG carried out a sabotage operation near the village of Osyan in Besta region.</s>
<s id="1:212">لە سەرتاسەری جیهان توندوتیژی بەرامبەر بە زیاتر لە یەک ملیار ژن ئەنجامدراوە.</s>	<s id="1:212">One billion women worldwide have been raped or harassed.</s>
<s id="1:213">ژنانیش نایانەوێت لە دژی ئەو توندوتیژییە بێدەنگ بن.</s>	<s id="1:213">Women refuse to assume passively this violence.</s>
<s id="1:214">بۆ ئەوەش کەمپەینی '#ملیارێک ڕادەپەڕن' داوای لە ژنان کرد ڕۆژی 14ی شوبات، ڕۆژی ڤالانتاین بڕژێنە سەرشەقامەکان.</s>	<s id="1:214">The One Billion Rising campaign called on women to get on their feet and protest on February 14.</s>
<s id="1:215">لە سەرتاسەری جیهان لە سێ ژن لە دژی یەکێکیان توندوتیژی و گوشار، پەلاماردان و دەستدرێژی و کردەوەی نەشیاو ڕوویانداوە. یەک لە سێ ژنیش بە مانای زیاتر لە یەک ملیار ژنی سەر زەوی دەکات.</s>	<s id="1:215">One in three women worldwide has been subjected to violence, beaten, forced to have sex, raped or mistreated. One in three women corresponds to 1 billion women.</s>
<s id="1:216">ڕۆژی شەممە 23ی خاکەلێوە، حوکمی ئێعدامی "مستەفا سەلیمی"، زیندانیی مەحکووم بە ئێعدام لە زیندانی سەقز جێبەجێ کرا.</s>	<s id="1:216">This morning, Saturday, April 11th, the death sentence of Mustafa Salimi, a prisoner sentenced to death, was carried out in Saqez Prison.</s>
<s id="1:217">ئەو زیندانییە پاش ناڕەزایەتیی زیندانییان لە زیندانی سەقز، توانی لە زیندان هەڵبێت؛ بە وتەی ڕۆژنامەنووسان و چالاکانی مافی مرۆیی کورد، ناوبراو پاش هەڵاتن لە زیندانی سەقز لە هەرێمی کوردستان دەسبەسەر دەکرێت و دواتر ڕادەستی حکوومەتی ئێران دەکرێتەوە.</s>	<s id="1:217">The prisoner escaped from the Saqez prison after the riots. According to Kurdish journalists and human rights activists, he was arrested in the Kurdistan Region after escaping from a prison and then handed over to the Iranian government.</s>
<s id="1:218">مستەفا سەلیمی لە دایکبووی 4ی پووشپەڕی ساڵی 1346ی هەتاویە، ڕێکەوتی 16ی خاکەلێوەی ساڵی 82 بە تۆمەتی "هاوکاری لەگەڵ یەکێک لە حیزبە کوردییەکان، دزیی چەکدارانە و موحاربە" لەلایەن دادگای ئینقلابی شاری سەقز، بە سەرۆکایەتی "گودینی" بە 15 ساڵ زیندان و ئێعدام مەحکووم کرابوو.</s>	<s id="1:218">Mustafa Salimi, was born on June 25th, 1967, was sentenced to 15 years in prison and death sentence by the Saqez Revolutionary Court, presided over by Judge Goodini, on April 5th, 2003 on charges of "membership in Kurdish parties, armed robbery, and moharebeh."</s>
<s id="1:219">حوکمی ئەو زیندانییە لە لقی 31ی دیوانی باڵای وڵات پشتڕاست و ئەو زیندانییە لە ماوەی دەسبەسەر کرانیدا، چەندین جار ناڕەزایەتی سەبارەت بە نادادپەروەرانەبوونی حوکمەکەی دەربڕیبوو و دەستی دابووە مانگرتن لە خواردن.</s>	<s id="1:219">The prisoner's sentence was upheld by Branch 31 of the Supreme Court, and the prisoner went on a hunger strike several times during his imprisonment to protest the unfairness of his sentence.</s>
<s id="1:220">ڕۆژی سێشەممەی حەوتووی ڕابردوو، هاووڵاتییەکی کورد بە ناوی "ئیسماعیل ئەردەوانی" کوڕی "جەلال"، تەمەن 32 ساڵ وخەڵکی گوندی "تەرخانئاوا"ی مەریوان، لەلایەن هێزە ئیتلاعاتییەکانەوە دەسبەسەر کرا و ڕەوانەی گرتنگەی ئیدارەی ئیتلاعاتی سنە کرا.</s>	<s id="1:220">On Tuesday, April 14th, a Kurdish citizen, Ismail Ardavani, 32, son of Jalal, from the village of Tarkhanabad, Marivan, was arrested by intelligence forces and transferred to the Sanandaj Intelligence Detention Center.</s>
<s id="1:221">بە وتەی سەرچاوەیەکی ئاگادار، هێزە ئیتلاعاتییەکان بە سێ ماشین و بەبێ بەڵگەی دادوەری هێرشیان کردووەتە سەر ماڵی ئەو هاووڵاتییە کوردە و ناوبراویان دەسبەسەر کردووە.</s>	<s id="1:221">According to an informed source, the intelligence forces raided the personal home of the Kurdish citizen and detained him without providing any legal permission.</s>
<s id="1:222">ئەو سەرچاوەیە هەروەها ئەوەشی خستەڕوو، هێزە ئیتلاعاتییەکان، ئەو هاووڵاتییە کوردەیان بە تۆمەتی "ئەندامبوون لە یەکێک لە حیزبە کوردییەکانی دژبەری حکوومەتی ئێران" دەسبەسەر کردووە.</s>	<s id="1:222">The informed source added: "Intelligence forces arrested this Kurdish citizen on charges of being a member of one of the Kurdish opposition parties of the Iranian government."</s>
<s id="1:223">"ئیسماعیل ئەردەوانی" خێزاندارە و هەنووکە لە گرتنگەی ئیدارەی ئیتلاعاتی شاری سنەدایە.</s>	<s id="1:223">Ismail Ardavani is currently being interrogated at the Sanandaj Intelligence Detention Center.</s>
<s id="1:224">لقی 2ی دادگای ئینقلابی شاری کرماشان، چوار چالاکی فەرهەنگیی کوردی بە ناوەکانی "شەهریار تەهماسبی و ئەردەشیر مووسەوی خەڵکی کرماشان، مستەفا باقری ئاشنا خەڵکی کەنگاوەر و ئەرسەلان هیدایەتی خەڵکی قوروە"، هەر کامەیانی بە 9 مانگ زیندانیی تەعزیری مەحکووم کرد.</s>	<s id="1:224">The Second Branch of the Kermanshah Revolutionary Court has sentenced four Kurdish cultural activists, Shahriar Tahmasebi from Kermanshah, Ardeshir Mousavi from Kermanshah, Mustafa Bagheri Ashna from Kangavar, and Arsalan Hedayati from Qorveh, to 9 months prison each.</s>
<s id="1:225">"شەهریار تەهماسبی" لە وتووژێک لەگەڵ ئاژانسی کوردپا وێڕای پشتڕاستکردنەوەی ئەم هەواڵە، ڕایگەیاند: "لقی دووی دادگای ئینقلابی کرماشان بە سەرۆکایەتیی شاهرۆخ مورادی، بە تۆمەتی پڕوپاگەندە دژی نیزام و دروستکردنی گرووپ بە مەبەستی تێکدانی نەزمی گشتی، ئەو حوکمەیان بەسەرماندا سەپاندووە".</s>	<s id="1:225">In an interview with Kurdpa, Shahriar Tahmasebi confirmed the news, saying that the Second Branch of the Kermanshah Revolutionary Court, presided over by Judge Shahrokh Moradi, had issued the verdict on charges of "propaganda against the regime and forming a group with the intent to disrupt public order."</s>
<s id="1:226">ڕۆژی پێنجشەممە 14ی پووشپەڕی ساڵی 97، "شەهریار تەهماسبی، ئەردەشیر مووسەوی و مستەفا باقری ئاشنا"، لەلایەن هێزە ئەمنییەتییەکانەوە دەسبەسەر کران و "ئەرسەلان هیدایەتی" ڕۆژی هەینی 15ی پووشپەڕی هەمان ساڵ دەسبەسەر کرا.</s>	<s id="1:226">Shahriyar Tahmasebi, Ardeshir Mousavi and Mostafa Bagheri Ashna were arrested by security forces on Thursday, July 5, 2018, and Arsalan Hedayati was arrested on Friday, July 5, 2018.</s>
<s id="1:227">ئەو چوار چالاکە فەرهەنگییە، پاش تەواوبوونی ماوەی لێپرسینەوەکەیان بە دانانی بارمتە بە شێوەی کاتی ئازاد کران.</s>	<s id="1:227">These four cultural activists were released on bail after interrogations.</s>
<s id="1:228">"ئەردەشیر مووسەوی و مستەفا باقری ئاشنا" لە ماوەی دەسبەسەرکرانیاندا، لە ڕێکەوتی چوارشەممە 17ی گەلاوێژی ساڵی 97 هەتا ڕۆژی چوارشەممە 7ی خەرمانانی 97، بە نیشانەی ناڕەزایەتی دەربڕین لە "بێبەریکردنیان لە مافی یاسایی و خەدەماتی دەرمانی" لە زیندانی دێزڵاوای کرماشان، مانیان لە خواردن گرتبوو.</s>	<s id="1:228">Ardeshir Mousavi and Mostafa Bagheri Ashna had been on a hunger strike in Dieselabad Prison in Kermanshah during the detention period from Wednesday, August 8, 2018 to Wednesday, August 29, 2018 in protest of "deprivation of legal rights and deprivation of medical services."</s>
<s id="1:229">ڕۆژی شەممە، 3ی ڕەشەمە، بەهۆی تەقینەوەی یەکێک لە مینە چێندراو و کۆنەکراوەکانی شەڕی ئێران و عێراق لە ناوچەی قەسریشیرین، مێرمنداڵێکی تەمەن 14 ساڵە گیانی لەدەست دا.</s>	<s id="1:229">A 14-year-old teenager, "Payam Rostami", died on Saturday, February 22nd, from a landmine explosion in Qasr-e Shirin.</s>
<s id="1:230">ڕۆژی یەکشەممە 31ی خاکەلێوە، "کامران عەبدی پوور"، زیندانیی پێشووی زیندانی سەقز، لەلایەن هێزە لیباس شەخسییەکانەوە لەو شارەدا دەسبەسەر کرا و بۆ شوێنێکی نادیار ڕاگوێزرا.</s>	<s id="1:230">On Sunday, April 19th, Kamran Abdipour, a former prisoner, was detained by plainclothes forces in Saqez and taken to an unknown location.</s>
<s id="1:231">هێزە لیباس شەخسییەکان بە بنەماڵەی "عەبدی پوور"یان ڕاگەیاندووە کە کامرانیان لە پەیوەندی لەگەڵ هاوکاریکردنی زیندانییە هەڵاتووەکان لە زیندانی سەقز دەسبەسەر کردووە.</s>	<s id="1:231">According to Abdipoor's family, plainclothes forces told them that Kamran had been arrested on charges of collaborating with fugitive prisoners at Saqez Prison.</s>
<s id="1:232">هەتا ئێستا بەدواداچوونی بنەماڵەی "عەبدی پوور" بۆ ئاگاداربوون لە شوێنی ڕاگیرانی کوڕەکەیان بێئاکام ماوەتەوە.</s>	<s id="1:232">So far, the efforts of Abdipoor's family to find out the whereabouts of their child has been fruitless.</s>
<s id="1:233">ڕۆژی شەممە 11ی خەزڵوەری ساڵی 98، "کامران (ڕەزا) عەبدی پوور" پاش 15 ساڵ زیندانی لە زیندانی سەقز بە لێخۆشبوونی بنەماڵەی کوژراوەکە لە "قیساس" ڕزگاری بوو.</s>	<s id="1:233">On Saturday, November 2nd, 2019, Kamran (Reza) Abdipoor was released from Saqez prison after 15 years in prison with the consent avengers of blood.</s>
<s id="1:234">ئەو هاووڵاتییە کوردە لە کاتی شەڕکردن لەگەڵ کەسێک کە بوو بەهۆی کوشتنی "محەممەد عەلیزادە" دەسبەسەر کرابوو و دواتر بە ئێعدام مەحکووم کرابوو.</s>	<s id="1:234">This Saqezi citizen was arrested during a clash that led to the murder of a man named "Mohammad Alizadeh" and was later sentenced to death.</s>
<s id="1:235">ئاژانسی کوردپا: لقی 2ی دادگای کەیفەریی شاری شنۆ، هاووڵاتییەکی بە ساڵێک زیندانی تەعزیری مەحکووم کرد.</s>	<s id="1:235">Kurdpa Agency: Branch 2 of the Oshnavieh Criminal Court sentenced a Kurdish citizen to one year in discretionary imprisonment.</s>
<s id="1:236">لقی 2ی دادگای کەیفەریی شاری شنۆ بە تۆمەتی "هاوکاری لەگەڵ یەکێک لە حیزبە کوردییەکانی ئۆپوزسیونی حکوومەتی ئێران" ئەو حوکمەی بە سەر ئەو هاووڵاتییە کوردەدا، سەپاندبوو.</s>	<s id="1:236">Branch 2 of the Oshnavieh Criminal Court has issued a sentence for this Kurdish citizen on charges of "cooperating with one of the Kurdish opposition parties of the Iranian government".</s>
<s id="1:237">20ی پووشپەڕ ئەمساڵ، ئەو هاووڵاتییە کوردە، لە لایەن هێزە ئیتلاعاتییەکانەوە دەسبەسەر کرا و ڕۆژی شەممە 16ی خەرمانان، لە گرتنگەی ئیدارەی ئیتلاعاتی شاری ورمێ بۆ گرتنگەی ئیدارەی ئیتلاعاتی نەغەدە ڕاگوێزرا.</s>	<s id="1:237">On Thursday, July 11th, Ali Esmaili was arrested by the intelligence forces and on Saturday, September 7th, he was transferred from the Urmia Intelligence detention center to the Naqadeh Intelligence Bureau.</s>
<s id="1:238">ناوبراو 27ی بەفرانباری ساڵی ڕابردوو، ئەم هاووڵاتییە کوردە بە تۆمەتی "هاوکاری لەگەڵ یەکێک لە حیزبە کوردییەکانی دژبەری حکوومەتی ئێران"، لە لایەن هێزە ئیتلاعاتییەکانەوە دەسبەسەر کرابوو.</s>	<s id="1:238">Also on Thursday, January 17th, 2019, this Kurdish citizen was arrested by the intelligence forces on charges of "cooperating with one of the Kurdish opposition parties of the Iranian government".</s>
<s id="1:239">لقی 101ی دادگای کەیفەریی دووی شنۆ، چالاکێکی ژینگەپارێزی، بە ناوی "ڕەشید ناسرزادە" کوڕی فەتاح بە 6ساڵ زیندانی تەعزیری مەحکووم کرد.</s>	<s id="1:239">Branch 101 of the Criminal Court II. Oshnavieh sentenced Rashid Naserzadeh, a Kurdish environmental activist to six years in discretionary imprisonment.</s>
<s id="1:240">دادگا ئەو چالاکە ژینگەپارێزییەی بە "کۆبوونەوە و تەبانی بەنیسبەت ئەنجامدانی تاوان دژی ئەمنییەتی ناوخۆیی نەتەوەیی و چالاکی و بانگەشە لە بەرژەوەندیی گرووپە دژبەرەکانی نیزام" تاوانبار کردووە.</s>	<s id="1:240">The court has charged this environmental activist with "gathering and colluding to commit crimes against national security and propaganda in favor of opposition and dissident groups."</s>
<s id="1:241">دادگا بە پشتبەستن بە مادەکانی 500 و 610 لە بەشی یاسای تەعزیرات و پێشگرتن لە تاوانەکانی یاسای سزای ئیسلامی؛ ئەو چالاکە ژینگەپارێزییە بە تۆمەتی "کۆبوونەوە و تەبانی بەنیسبەت ئەنجامدانی تاوان دژی ئەمنییەتی ناوخۆیی ئێران" بە 5 ساڵ زیندانی تەعزیری و هەروەها بە تۆمەتی "پرۆپاگەندە دژی نیزام" بە ساڵێک زیندانی تەعزیری مەحکووم کرد.</s>	<s id="1:241">The court, citing Articles 500 and 610 of the chapter on punishments and penalties deterrent by the Islamic Penal Code, and Article 134 of the Penal Code, sentenced this environmental activist to five years in prison on charges of "gathering and colluding to commit crimes against national security" and also, he has been sentenced to one year in prison on charges of "propaganda against the system", with the use of severe punishments, including previous prison terms.</s>
<s id="1:242">داسەپاندنی ئەو حوکمە بە سەر ئەو چالاکە مەدەنییە کوردە، بە پشتبەستن بە ڕاپۆرتەکانی ئیدارەی ئیتلاعاتی شاری شنۆ و مەئموورانی قەزایی دادسەرای گشتی و ئینقلابی شاری شنۆ بووە.</s>	<s id="1:242">The ruling was issued for the Kurdish activist, citing reports by the Oshnavieh Intelligence Bureau and the Judicial Bureau of the Oshnavieh Public Prosecutor's Office and Revolutionary Court.</s>
<s id="1:243">ئەو چالاکە مەدەنییە بە تۆمەتی "سیخوری بۆ گرووپەکانی ئۆپوزسیونی نیزام" بە پشتبەستن بە ئەسڵی 37 یاسای بنەڕەتی و مادەی 4ی ئایینی دادڕەسی کەیفەری بێتاوان ناسرابوو.</s>	<s id="1:243">This civil activist has been acquitted of "espionage for opposition groups" based on Article 37 of the Constitution and Article 4 of the Criminal Procedure Code.</s>
<s id="1:244">ئەو حوکمە ڕۆژی پێنجشەممە 7ی خاکەلێوە، بە ڕەشید ناسرزادە ڕاگەیەندراوە.</s>	<s id="1:244">This sentence was announced on Thursday, March 26th, to Rashid Naserzadeh.</s>
<s id="1:245">ئەو چالاکە ژینگەپارێزییە، ڕۆژی سێشەممە 12ی سەرماوەزی98ی هەتاوی ، لە کاتی گەڕانەوە لە هەرێمی کوردستان لە جادەی پیرانشار شنۆ، لەلایەن هێزە ئیتلاعاتییەکانەوە دەسبەسەر کرا.</s>	<s id="1:245">This environmental activist from Oshnavieh was arrested by intelligence forces on Tuesday, December 3rd, 2019 was arrested on Piranshahr-Oshnavieh Road.</s>
<s id="1:246">ڕەشید ناسرزادە، ڕۆژی پێنجشەممە 26ی سەرماوەزی هەمان ساڵ، پاش 44 ڕۆژ لە دەسبەسەری بە دانانی بارمتەی 200 میلیۆن تمەنی ئازاد کرابوو.</s>	<s id="1:246">Rashid Nasarzadeh was released on 200 million Tomans bail, on Thursday, January 16th, 2020 after 44 days' detention.</s>
<s id="1:247">ڕۆژی سێشەممە 16ی بانەمەڕ، هاووڵاتییەکی کورد بە ناوی "ئیدریس گەلەداری" خەڵکی سنە، لەلایەن هێزە ئەمنییەتییەکانەوە دەسبەسەر کرا و بۆ شوێنێکی نادیار ڕاگوێزرا.</s>	<s id="1:247">On Tuesday, May 5th, a Kurdish citizen named "Idris Galedari" from Sanandaj was arrested by security forces and taken to an unknown location.</s>
<s id="1:248">بە وتەی سەرچاوەیەکی ئاگادار، سەرەڕای 6 ڕۆژ تێپەڕین بەسەر دەسبەسەرکرانی ئەو هاووڵاتییە کوردە، هیچ زانیارییەک لەمەڕ چارەنووسی "ئیدریس گەلەداری" لەبەر دەستدا نییە.</s>	<s id="1:248">According to an informed source, six days after the arrest of the Kurdish citizen, his fate is unknown.</s>
<s id="1:249">ئەو سەرچاوە ئاگادارە ئەوەشی خستەڕوو: "ئەو هاووڵاتییە سنەییە لە کاتێکدا بۆ کاری پەیوەندیدار بە دڵنیایی ماشینەکەی (بیمە خودرو) سەردانی یەکێک لە شیرکەتەکانی کردبوو، لەلایەن هێزە ئەمنییەتییەکانەوە دەسبەسەر کراوە".</s>	<s id="1:249">The informed source said: "This citizen of Sanandaj, while he had referred to one of the relevant companies for his personal car insurance, has been arrested by the security forces."</s>
<s id="1:250">ئەو سەرچاوە ئاگادارە هەورەها دەڵێت: "هێزە ئەمنییەتییەکان پاش دەسبەسەرکردنی ئەو هاووڵاتییە کوردە، هێرشیان کردووەتە سەر ماڵەکەی و هەندێک کەرەستەی کەسیی نابراویان وەک کامپیۆتێر، لەگەڵ خۆیان بردووە".</s>	<s id="1:250">The informed source added: "After the arrest of this citizen, the security forces raided his private house and confiscated some of his personal belongings, including his computer."</s>
<s id="1:251">ئەو سەرچاوەیە لە درێژەدا، ئەوەشی ڕاگەیاند: "دوو برای ئیدریس گەلەداری ئەندامی یەکێک لە حیزبە کوردییەکانی ئۆپۆزسیۆنی حکوومەتی ئێرانن".</s>	<s id="1:251">The source said: " two brothers of Idris Galedari are members of one of the Kurdish opposition parties of the Iranian government."</s>
<s id="1:252">هەتا کاتی بڵاوبوونەوەی ئەم هەواڵە، لە هۆکاری دەسبەسەرکردنی ئەو هاووڵاتییە سنەییە هیچ زانیارییەک لەبەر دەستدا نییە.</s>	<s id="1:252">No information is available on the reason for the arrest and detention of this citizen from Sanandaj, as of this writing.</s>
<s id="1:253">ڕۆژی شەممە 6ی بانەمەڕ، هاووڵاتییەک بە ناوی "جەمیل خادم" تەمەن 42 ساڵ، لە سێڕێیانی "سێروو"ی ورمێ، لەلایەن هێزە ئەمنییەتییەکانەوە دەسبەسەر کرا و بۆ شوێنێکی نادیار ڕاگوێزرا.</s>	<s id="1:253">On Saturday, April 25th, a Kurdish citizen named Jamil Khadem, 42, was detained by intelligence forces at the Sarv intersection in Urmia and taken to an unknown location.</s>
<s id="1:254">هێزە ئەمنییەتییەکان هۆکاری دەسبەسەرکردنی ئەو هاووڵاتییە کوردەیان، "هاوکاریکردن لەگەڵ یەکێک لە حیزبە کوردییەکانی ئۆپۆزسیۆنی حکوومەتی ئێران" ڕاگەیاندووە.</s>	<s id="1:254">Intelligence forces said the reason for the citizen's arrest was "cooperation with one of the Kurdish opposition parties of the Iranian government."</s>
<s id="1:255">هەتا کاتی بڵاوبوونەوەی ئەم هەواڵە، بەدواداچوونی بنەماڵەی "جەمیل خادم" بۆ ئاگاداربوون لە چارەنووس و شوێنی ڕاگیرانی ناوبراو بێئاکام ماوەتەوە.</s>	<s id="1:255">Until the moment of publication of this news, the citizen's family's efforts to find out whereabouts and his fate has been unsuccessful.</s>
<s id="1:256">ڕۆژی سێشەممە 30ی بانەمەڕ، شەڕ و تێکەڵچوون لەنێوان هێزەکانی سپای پاسداران و گرووپێکی چەکدار لە مەریوان هاتە ئاراوە.</s>	<s id="1:256">On Tuesday, May 20, an armed clash took place between Revolutionary Guards and an armed group in the Kaniguiz Heights between the villages of Rasha Deh and Dowaisa in Marivan.</s>
<s id="1:257">بەشی پەیوەندییە گشتییەکانی قەراگای حەمزە بە بڵاوکردنەوەی ڕاگەیەندراوێک، ڕایگەیاند کە قەرارگای شەهرامفەڕی هێزە زەوینییەکانی سپای پاسداران لە ئۆپراسیۆنێکی هاوبەش لەگەڵ ئیدارەی ئیتلاعاتی کوردستان، لەگەڵ گرووپێکی چەکدار لە ناوچەی مەریوان تووشی شەڕ و تێکەڵچوون بوون.</s>	<s id="1:257">Hamzeh Camp Public Relations announced in a statement that the IRGC's Shahramfar Camp in an joint operation with the Kurdistan Intelligence Agency have clashed with an armed group in the Marivan public area.</s>
<s id="1:258">قەرارگای حەمزە لەو ڕاگەیەندراوەدا ئیدعای کردووە کە لەو شەڕەدا، دوو کەس لەو گرووپە چەکدارە کوژراون و چوار کەسی دیکەیان بریندار بوون.</s>	<s id="1:258">The Hamza base claimed in a statement that two members of the militant group were killed and four others were wounded in the clashes.</s>
<s id="1:259">پاش ئەو شەڕ و تێکەڵچوونە سپای پاسداران شوێنی شەڕەکەیان تۆپباران کرد.</s>	<s id="1:259">Following the clashes, the Revolutionary Guards shelled the scene.</s>
<s id="1:260">سپای پاسداران ئەو شەڕەی داوەتە پاڵ حیزبە کوردییەکانی ئۆپۆزسیۆنی حکوومەتی ئێران، بەڵام هەتا ئێستا هیچ حیزب و لایەنێکی سیاسی، ئەو شەڕەی لە ئەستۆ نەگرتووە.</s>	<s id="1:260">The Revolutionary Guards have attributed the clash to Kurdish opposition parties in the Iranian government, but so far no one claimed the responsibility for the clash.</s>
<s id="1:261">لەو پەیوەندییەدا، ڕۆژی سێشەممە 16ی بانەمەڕ، هێزەکانی سپای پاسداران لەگەڵ گرووپێکی چەکداری نەناسراو، لە "چلچەمە"ی دیواندەرە دەرگیر بوون و "شەکیبا سەلیمی"، لە فەرماندەکانی سپای پاسداران، لەگەڵ "جەعفەر نیزامپوور و محەممەد شوکری"، دوو ئەندامی تری سپا، لەو تێکەڵچوونەدا کوژران.</s>	<s id="1:261">On Tuesday, May 5, IRGC forces clashed with an armed group in Chehel Cheshmeh, Divandarreh, in which Shakiba Salimi, an IRGC commander, and Jafar Nezampour and Mohammad Shokri, two other IRGC members, were killed.</s>
<s id="1:262">هاووڵاتییەکی کوردی کرماشانی بە ناوی "عوبەید عەزیزنژاد"، لەلایەن دادگای ئینقلابی ئەو شارەوە بە 6 مانگ زیندانیی تەعزیری مەحکووم کرا.</s>	<s id="1:262">In recent days, a Kurdish citizen, Obaid Aziz Nejad, from Kermanshah, has been detained by intelligence forces and taken to an unknown location.</s>
<s id="1:263">ڕۆژی دووشەممە 18ی خاکەلێوە، کۆڵبەرێکی کورد بە ناوی "بورهان جنکانلو" تەمەن 28 ساڵ، خەڵکی شاری بازرگان سەر بە ماکۆ، لە بەرزاییەکانی سنووری ئەو شارە بە تەقەی هێزە نیزامییەکانی حکوومەتی ئێران گیانی لەدەست دا و دوو کۆڵبەری دیکە بریندار بوون.</s>	<s id="1:263">On Monday, April 6, a Kurdish kolbar named Borhan Jankanlu, 28, resident of Bazargan, Maku, was killed in a direct firings by government troops and two other Kolbars were wounded.</s>
<s id="1:264">"بورهان جنکانلوو" خێزاندار و باوکی دوو منداڵە.</s>	<s id="1:264">Borhan Jankanlu is married and has two children.</s>
<s id="1:265">سەرلەبەیانیی ئەمڕۆ یەکشەممە 14ی بانەمەڕ، کۆڵبەرێکی کورد بە ناوی "مەحموود مورادی" کوڕی حاجی "جەلال"، بە تەقەی هێزە نیزامییەکانی حکوومەت لە سنووری "هەنگەژاڵ"ی بانە گیانی لەدەست دا. ئەم کۆڵبەرە کوردە ماوەی 18 ڕۆژە ژیانی هاوبەشی پێکهێناوە.</s>	<s id="1:265">This morning, Sunday, May 3rd, a Kurdish Kolbar named "Mahmoud Moradi", the son of Haj Jalal, died as a result of direct fire from government troops on the "Hangeh zhal" border in Baneh.</s>
<s id="1:266">سەرلەبەیانیی ئەمڕۆ پێنجشەممە 4ی بانەمەڕ، زیندانییەک بە ناوی "سینا محەممەدی" خەڵکی گوندی "سرنجیانە"ی شاری دێولان کە بە تۆمەتی "کوشتنی بەئەنقەست" لە زیندان بوو، سەرەڕای هەوڵی چالاکانی مەدەنی بۆ لێخۆشبوونی بنەماڵەی کوژراوەکە لە ئێعدامکردنی ئەو زیندانییە، لەسێدارە درا.</s>	<s id="1:266">This morning, Thursday, April 23rd, a prisoner accused of "murder" named "Sina Mohammadi" from the village of "Serenjianeh", Dehgolan was executed despite the efforts of civil activists to obtain the consent of the victim's family.</s>
<s id="1:267">ئەو زیندانییە چەند ڕۆژ پێش بۆ جێبەجێکردنی حوکمەکەی ڕەوانەی ژووری تاکەکەسیی زیندانی ناوەندیی سنە کرابوو.</s>	<s id="1:267">This prisoner was transferred to solitary confinement in Sanandaj Central Prison a few days ago to serve his sentence.</s>
<s id="1:268">"سینا محەممەدی" لە کاتێکدا کە تەمەنی لەژێر 18 ساڵدا بوو، تووشی ئەو تاوانە ببوو و دواتر بە قیساس مەحکووم کرا.</s>	<s id="1:268">Sina Mohammadi had committed murder at the age of less than 18 and was later sentenced to retaliation.</s>
<s id="1:269">لەو پەیوەندییەدا، سەرلەبەیانیی چوارشەممە 3ی بانەمەڕ، حوکمی لەسێدارەدانی "لوقمان ئەحمەدپوور" خەڵکی بانە، زیندانیی تاوانبار بە "کوشتنی بەئەنقەست"، لە زیندانی ناوەندیی سنە جێبەجێ کرا.</s>	<s id="1:269">In this regard, on Wednesday, April 22nd, the death sentence of a prisoner accused of "premeditated murder" named "Loghman Ahmadpour" from Baneh was carried out in Sanandaj Central Prison.</s>
<s id="1:270">ئەو زیندانییە ماوەی سێ ساڵ پێش بە تۆمەتی "کوشتنی بەئەنقەست" لە بانە دەسبەسەر کرا و دواتر بە قیساس مەحکووم کرابوو.</s>	<s id="1:270">This prisoner was arrested three years ago on charges of "premeditated murder" in Baneh and later sentenced to retaliation.</s>
<s id="1:271">هەروەها، ڕۆژی سێشەممە 2ی بانەمەڕ، "شایان سەعیدپوور"، زیندانیی مەحکووم بە ئێعدام لە زیندانی سەقز لەسێدارە درا.</s>	<s id="1:271">Also, on Tuesday, April 21st, Shayan Saeedpour, a prisoner sentenced to death, was executed in Saqez Prison.</s>
<s id="1:272">ڕێکەوتی 28ی گەلاوێژی ساڵی 94، "شایان سەعیدپوور" لە کاتێکدا کە تەمەنی کەمتر لە 18 ساڵ بوو، لە ئەنجامی شەڕ و دەمەقاڵێ کەسێکی بە ناوی "سلێمان ئازادی" کوشتبوو.</s>	<s id="1:272">On August 19th, 2015, Shayan Saeedpour, while under the age of 18, in a clash with a citizen killed a person named Suleman Azadi.</s>
<s id="1:273">ناوبراو مانگی خەزەڵوەری ساڵی 97، لەلایەن لقی یەکی دادگای کەیفەریی یەکی سنە بە سەرۆکایەتی دادوەر "وەفاییان" بە ئێعدام مەحکووم کرا و ئەو حوکمەش لە مانگی بەفرانباری هەمان ساڵ لەلایەن دیوانی باڵای وڵاتەوە پشتڕاست کرابووە.</s>	<s id="1:273">He was sentenced to death by the First Branch of the Criminal Court of Sanandaj on October 23rd, 2018 under the chairmanship of Judge Vafaeian, and the verdict was upheld by the Supreme Court in February.</s>
<s id="1:274">ئاژانسی کوردپا: "بەسیجی خوێندکاریی" زانکۆی ئیلام، پێشیان لە بڵاوکردنەوەی گۆڤارێکی فەرهەنگیی کورد کرد.</s>	<s id="1:274">Kurdpa Agency: Students' Basij at the University of Ilam prevented the publication of a Kurdish cultural magazine.</s>
<s id="1:275">بەپێی ڕاپۆرتی گەیشتوو بە ئاژانسی هەواڵدەریی کوردپا، "بەسیجی خوێندکاریی" زانکۆی ئیلام، پێشیان بە بڵاوکردنەوەی گۆڤارێکی ئەدەبی و فارسی بە ناوی "ڕێبەندان خوەشە" گرت.</s>	<s id="1:275">According to a report by the Kurdistan Press Agency, students' Basij at the University of Ilam prevented the publication of the Persian literary and cultural magazine "Rebandan Khosha".</s>
<s id="1:276">بە وتەی سەرچاوەیەکی ئاگادار، پێشگرتن لە بڵاوکردنەوەی ئەو گۆڤارە لە زانکۆی ئیلام لە کاتێکدایە کە سەرنووسەری ئەو گۆڤارە، موڵەتی چاپ و بڵاوکردنەوەی لە زانکۆ وەرگرتبوو.</s>	<s id="1:276">According to an informed source, blocking the publication of this cultural magazine at the University of Ilam was granted by the university's licensed publisher.</s>
<s id="1:277">ئەو سەرچاوەیە هەورەها دەڵێت: ""بەسیجی خوێندکاریی" زانکۆی ئیلام، بە بانگهێشتکردنی "محەممەد غەیاسوەند"، خاوەن ئیمتیازی گۆڤاری فەرهەنگیی ئەدەبی و فارسی "ڕێبەندان خوەشە"، هەڕەشەیان لە نابراو کردووە.</s>	<s id="1:277">The students' Basij at the University of Ilam has been threatened by summoned Mohammad Ghiasvand, the holder of the literary and Persian cultural magazine "Rebandan khosha".</s>
<s id="1:278">گۆڤاری فەرهەنگیی ئەدەبی و فارسی "ڕێبەندان خوەشە" لە یەکەم ژمارەی خویدا، باسی لە شێعر، فەرهەنگ، وێژە و مێژووی کوردستان کردبوو کە "بەسیجی خوێندکاریی" زانکۆی ئیلام پێشی بە بڵاوکردنەوەی گرت.</s>	<s id="1:278">In its first issue, the literary and Persian cultural magazine "Rebandan khosha" addressed the poetry, culture, literature and history of Kurdistan, which prevented by students' Basij of Ilam University.</s>
<s id="1:279">ڕۆژی پێنجشەممە 14ی خاکەلێوە، "تەحسین دادڕەس" زیندانیی سیاسیی کورد خەڵکی گوندی "سەردۆش" سەر بە شاری مەریوان، لە زیندانی ئەو شارە، بۆ زیندانی ناوەندی شاری سنە ڕاگوێزرا.</s>	<s id="1:279">On Thursday, April 2nd, "Tahsin Dadras", a Kurdish political prisoner from the village of Sardoush, was transferred from Marivan to the central prison of Sanandaj.</s>
<s id="1:280">بە وتەی سەرچاوەیەکی ئاگادار، ئەو زیندانییە سیاسییە کوردە بەهۆی ئەویکە هاوکاری لەگەڵ ناوەندە حکوومەتییەکانی ڕەت کردبووە لەلایەن جێگری بەرپرسی ئیدارەی ئیتلاعاتی مەریوان خرابووە ژێر گوشارەوە.</s>	<s id="1:280">According to an informed source, this Kurdish political prisoner has rejected the request of the Marivan Intelligence Bureau to cooperate with the agency and the deputy head of the Marivan Intelligence Department had pressured on this political prisoner.</s>
<s id="1:281">ئەو سەرچاوەیە هەورەها دەڵێت: "بۆ چەندەمین کەڕەت، بەرپرسانی ئیدارەی ئیتلاعاتی مەریوان، لەگەڵ هاتنە مەرەخەسی ئەو زیندانییە کوردە، دژایەتییان کردبوو".</s>	<s id="1:281">This source added: For several times, Marivan Prison and Intelligence officials have opposed to leave of absence the political prisoner.</s>
<s id="1:282">ئەو زیندانییە سیاسییە کوردە، ساڵی 97 بۆ تێپەڕاندنی ماوەی زیندانیبوونەکەی ڕەوانەی زیندانی مەریوان کراوە و لەو ماوەیەدا، لە مافی مورەخەسی بێبەری بووە.</s>	<s id="1:282">This political prisoner was transferred to Marivan Prison for a term of imprisonment in 1397 and was deprived of his leave during his imprisonment.</s>
<s id="1:283">ئێوارەی پێنجشەممە، 9ی سەرماوەزی ساڵی 96، "تەحسین دادڕەس" بە تۆمەتی "هاوکاری لەگەڵ یەکێک لە حیزبە کوردییەکانی دژبەری حکوومەتی ئێران"، لە لایەن هێزە ئیتلاعاتییەکانەوە دەسبەسەر و پاش حەوتوویەک لە دەسبەسەری لە ئێدارەی ئیتلاعاتی شاری مەریوان، بۆ ئیدارەی ئیتلاعاتی شاری سنە، ڕاگوێزرا.</s>	<s id="1:283">On Thursday, November 30th, 2017, Tahsin Dadras was arrested by the intelligence agents on charges of "cooperating with one of the Kurdish opposition parties" and transferred to the Sanandaj Intelligence Bureau after a week of detention.</s>
<s id="1:284">ئەو هاووڵاتییە کوردە، مانگی گەلاوێژی ساڵی 97، لە دادگای سەرەتایی، بە تۆمەتی "هەوڵدان دژی تەناهیی نەتەوەیی و هاوکاری لەگەڵ یەکێک لە حیزبە کوردییەکانی ئۆپۆزسیۆنی حکوومەتی ئێران"، بە 11 ساڵ زیندانیی تەعزیری و دواتر ئەو حوکمە لە دادگای پێداچوونەوەی سنە، بە 6 ساڵ زیندانیی تەعزیری، گۆڕدرا.</s>	<s id="1:284">This Kurdish citizen was sentenced to eleven years imprisonment in the district court in August 1397 on a charge of "acting against national security and cooperating with the Kurdish opposition parties" and then changed to a six-year sentence in the appeals court in Sanandaj.</s>
<s id="1:285">ئەو زیندانییە سیاسییە کوردە، لە ماوەی دەسبەسەرکرانیدا، لە "دەسپێڕاگەیشتن بە پارێزەر" بێبەری کراوە.</s>	<s id="1:285">This Kurdish political prisoner was denied "access to a lawyer" during his detention.</s>
<s id="1:286">ڕۆژی چوارشەممە 24ی بانەمەڕ، ژمارەیەک لە کۆڵبەرانی کورد لە نزیک دوو گوندی "مادلوو" و "وەکیل" سەر بە شاری چاڵدێران، کەوتنە بۆسەی هێزە نیزامییەکانی حکوومەت و سێ کۆڵبەر بەتوندی بریندار بوون.</s>	<s id="1:286">On Wednesday, May 13, a group of Kurdish Kolbars have ambushed by government troops near the two border villages of Madlu and Vakil in Chaldoran and they were injured severely.</s>
<s id="1:287">لە ئەنجامی تەقەی هێزە نیزامییەکانی حکوومەت، "ڕەزا سەرشیری"، "مەناف حەسەنزادە" لە لای ئەژنۆ و "بێهزاد ڕەمەزانی" لە لای ناوقەدیەوە پێکراون.</s>	<s id="1:287">Reza Sarshiri, Manaf Hassanzadeh were injured in the knee and Behzad Ramezani was injured in the back.</s>
<s id="1:288">لەو پەیوەندییەدا، ڕۆژی سێشەممە 23ی بانەمەڕ، کۆڵبەرێکی کورد بە ناوی "کامران مەولانیا" کوڕی "ئیسماعیل"، تەمەن 32 ساڵ و خەڵکی گوندی "گەوەڵان"ی سەردەشت بە تەقەی هێزە نیزامییەکانی حکوومەت گیانی لەدەست دا.</s>	<s id="1:288">In this regard, On Tuesday, May 12, a Kurdish Kolbar named Kamran Molania, 32, son of Ismail, from the village of Guolan, was shot dead by Iranian government forces at the Sardasht's border.</s>
<s id="1:289">"سەعید سەنگەر"، زیندانیی سیاسیی کورد لە گرتووخانەی ناوەندیی ورمێ، لەلایەن لقی 2ی دادگای ئینقلابی ئەو شارە، بە سەرۆکایەتی دادوەر "شێخلوو"، بە 15 ساڵ زیندان مەحکووم کرا.</s>	<s id="1:289">Saeed Sangar, a political prisoner imprisoned in Urmia Prison, was sentenced by the Second Branch of the Revolutionary Court of this city to 15 years in prison, presided over by Judge Sheikhlou.</s>
<s id="1:290">سەر لە بەیانی ئەمڕۆ سێشەممە 2ی بانەمەڕ، شایان سەعیدپوور، زیندانیی مەحکووم بە ئێعدام لە زیندانی سەقز لە سێدارە درا.</s>	<s id="1:290">This morning, Tuesday, April 21st, Shayan Saeedpour, a prisoner sentenced to death, was executed in Saqez Prison.</s>
<s id="1:291">بنەماڵەی "شایان سەعیدپوور"، که ڕۆژی دووشەممە 1ی بانەمەڕ، بۆ دوایین چاوپێکەوتن لەگەڵ کوڕەکەیان بانگهێشتی زیندانی سنە کرابوون و هەروەها هەوڵەکانی هاووڵاتییانی و پیاوماقووڵانی شاری سەقز، بۆ وەرگرتنی ڕەزامەندیی بنەماڵەی کوژراوەکە، بۆ پێشگرتم لە سێدارەدانی ئەو زیندانییە مەحکووم بە سێدارەیە، بێئاکام ماویەوە.</s>	<s id="1:291">Yesterday, Saeedpour's family was called to the prison for the last visit, and the efforts of the citizens and trustees of Saqez to obtain the consent of the avengers of blood to prevent the execution of this prisoner sentenced to retaliation were fruitless.</s>
<s id="1:292">ڕۆژی 8ی خاکەلێوە، "شایان سەعیدپوور'' لە ئەنجامی ناڕەزایەتییەکان لە زیندانی سەقز توانی لە زیندان هەڵبێت.</s>	<s id="1:292">On March 27th, Shayan Saeedpour escaped from Saqez Prison following an uprising in Saqez Prison.</s>
<s id="1:293">ئەو زیندانییە مەحکووم بە ئێعدامە دواتر لەلایەن هێزە ئیتلاعاتییەکانەوە دەسبەسەر کرا و بۆ زیندانی سنە ڕاگوێزرا.</s>	<s id="1:293">The prisoner sentenced to death was later arrested by intelligence and transferred to Sanandaj Prison.</s>
<s id="1:294">ڕێکەوتی 28ی گەلاوێژی ساڵی 94، شایان سەعیدپوور لە کاتێکدا کە تەمەنی کەمتر لە 18 ساڵ بوو، لە ئەنجامی شەڕ و دەمەقاڵێ کەسێکی بە ناوی "سلێمان ئازادی" کوشت.</s>	<s id="1:294">On August 19th, 2015, Shayan Saeedpour, while under the age of 18, in a clash with a citizen killed a person named Suleman Azadi.</s>
<s id="1:295">ناوبراو مانگی خەزەڵوەری ساڵی 97، لەلایەن لقی یەکی دادگای کەیفەریی یەکی سنە بە سەرۆکایەتی دادوەر "وەفاییان" بە ئێعدام مەحکووم کرا و ئەو حوکمەش لە مانگی بەفرانباری هەمان ساڵ لەلایەن دیوانی باڵای وڵاتەوە پشتڕاست کرابووە.</s>	<s id="1:295">He was sentenced to death by the First Branch of the Criminal Court of Sanandaj on October 23rd, 2018 under the chairmanship of Judge Vafaeian, and the verdict was upheld by the Supreme Court in February.</s>
<s id="1:296">سەر لە بەیانی ئەمڕۆ شەممە 23ی خاکەلێوە، حوکمی ئێعدامی "مستەفا سەلیمی"، زیندانیی مەحکووم بە ئێعدام لە زیندانی سەقز جێبەجێ کرا.</s>	<s id="1:296">This morning, Saturday, April 11th, the death sentence of Mustafa Salimi, a prisoner sentenced to death, was carried out in Saqez Prison.</s>
<s id="1:297">ئەو زیندانییە بۆ جێبەجێ کردنی حوکمەکەی لە ڕۆژانی ڕابردوودا، بۆ ژووری تاکەکەسیی گوازرابووە.</s>	<s id="1:297">The prisoner was transferred to solitary confinement in the past few days to serve his sentence.</s>
<s id="1:298">ئەو زیندانییە پاش ناڕەزایەتیی زیندانییان لە زیندانی سەقز، توانی لە زیندان هەڵبێت؛ بە وتەی ڕۆژنامەنووسان و چالاکانی مافی مرۆیی کورد، ناوبراو پاش هەڵاتن لە زیندانی سەقز لە هەرێمی کوردستان دەسبەسەر دەکرێت و دواتر ڕادەستی حکوومەتی ئێران دەکرێتەوە.</s>	<s id="1:298">The prisoner escaped from the Saqez prison after the riots. According to Kurdish journalists and human rights activists, he was arrested in the Kurdistan Region after escaping from a prison and then handed over to the Iranian government.</s>
<s id="1:299">مستەفا سەلیمی لە دایکبووی 4ی پووشپەڕی ساڵی 1346ی هەتاویە، ڕێکەوتی 16ی خاکەلێوەی ساڵی 82 بە تۆمەتی "هاوکاری لەگەڵ یەکێک لە حیزبە کوردییەکان، دزیی چەکدارانە و موحاربە" لەلایەن دادگای ئینقلابی شاری سەقز، بە سەرۆکایەتی "گودینی" بە 15 ساڵ زیندان و ئێعدام مەحکووم کرابوو.</s>	<s id="1:299">Mustafa Salimi, was born on June 25th, 1967, was sentenced to 15 years in prison and death sentence by the Saqez Revolutionary Court, presided over by Judge Goodini, on April 5th, 2003 on charges of "membership in Kurdish parties, armed robbery, and moharebeh."</s>
<s id="1:300">حوکمی ئەو زیندانییە لە لقی 31ی دیوانی باڵای وڵات پشتڕاست و ئەو زیندانییە لە ماوەی دەسبەسەر کرانیدا، چەندین جار ناڕەزایەتی سەبارەت بە نادادپەروەرانەبوونی حوکمەکەی دەربڕیبوو و دەستی دابووە مانگرتن لە خواردن.</s>	<s id="1:300">The prisoner's sentence was upheld by Branch 31 of the Supreme Court, and the prisoner went on a hunger strike several times during his imprisonment to protest the unfairness of his sentence.</s>
<s id="1:301">"هاوپێوەندی بۆ ئازادی و بەرانبەری لە ئێران" لە بەیاننامەیەکدا لەسێدارەدانی "مستەفا سەلیمی"ی مەحکووم کرد و خوازیاری لابردنی سزای ئێعدام لە دەزگای دادوەریی ئێران بوو.</s>	<s id="1:301">This morning, Saturday, April 11th, the death sentence of Mustafa Salimi, a prisoner sentenced to death, was carried out in Saqez Prison.</s>
<s id="1:302">"مستەفا سەلیمی" لەدایکبووی 4ی پووشپەڕی ساڵی 1346ی هەتاوییە، ڕێکەوتی 16ی خاکەلێوەی ساڵی 82 بە تۆمەتی "هاوکاری لەگەڵ یەکێک لە حیزبە کوردییەکان، دزیی چەکدارانە و موحاربە" لەلایەن دادگای ئینقلابی شاری سەقز، بە سەرۆکایەتیی "گودینی"، بە 15 ساڵ زیندان و ئێعدام مەحکووم کرابوو.</s>	<s id="1:302">Mustafa Salimi, was born on June 25th, 1967, was sentenced to 15 years in prison and death sentence by the Saqez Revolutionary Court, presided over by Judge Goodini, on April 5th, 2003 on charges of "membership in Kurdish parties, armed robbery, and moharebeh."</s>
<s id="1:303">حوکمی ئەو زیندانییە لە لقی 31ی دیوانی باڵای وڵات پشتڕاست کرایەوە و ئەو زیندانییە لە ماوەی دەسبەسەرکرانیدا چەندین جار سەبارەت بە نادادپەروەرانەبوونی حوکمەکەی ناڕەزایەتیی دەربڕیبوو و دەستی دابووە مانگرتن لە خواردن.</s>	<s id="1:303">The prisoner's sentence was upheld by Branch 31 of the Supreme Court, and the prisoner went on a hunger strike several times during his imprisonment to protest the unfairness of his sentence.</s>
<s id="1:304">ئەمڕۆ شەممە 27ی بانەمەڕ، حەوتوویەک بەسەر ناڕوونیی چارەنووسی "هیدایەت عەبدوڵڵاپوور"، زیندانیی سیاسیی کوردی مەحکووم بە ئێعدام لە گرتووخانەی ورمێ، تێدەپەرێت.</s>	<s id="1:304">Today, Saturday, May 16, a week has passed since the disappearance of Hedayat Hedayat Abdullahpour, a Kurdish political prisoner sentenced to death in Urmia Prison.</s>
<s id="1:305">هەتا ئێستا بەدواداچوونەکانی بنەماڵەی ئەو زیندانییە سیاسییە کوردە، بۆ ئاگاداربوون لە چارەنووس و شوێنی ڕاگیرانی "هیدایەت عەبدوڵڵاپوور" بێئاکام ماوەتەوە.</s>	<s id="1:305">So far, the political prisoner's family's efforts to find out his fate and whereabouts have been unsuccessful.</s>
<s id="1:306">ڕۆژی سێشەممە 23ی بانەمەڕ، ڕێکخراوی لێبووردنی نێونەتەوەیی بە بڵاوکردنەوەی بەیاننامەیەک داوایان لە بەرپرسانی حکوومەتی ئێران کرد، هەرچی زووتر چارەنووس و شوێنی ڕاگیرانی "حوسێن سەیلاوی، عەلی خسرەجی و ناسر خەفاجیان (خەفاجی)"، سێ زیندانیی عەرەب لە ڕیزی ئێعدام لە نەتەوەی عەرەبی ئەهوازی و "هیدایەت عەبدوڵڵاپوور"، زیندانیی لە ڕیزی ئێعدام لە نەتەوەی کورد، ڕوون بکاتەوە.</s>	<s id="1:306">On Tuesday, May 12, Amnesty International issued a statement urging Iranian government officials to immediately determine the fate and whereabouts of Hossein Silavi, Ali Khosarji and Naser Khafajian (Khafaji), three prisoners on death row from the Ahwazi Arab minority, and Hedayat Abdullahpour, a prisoner from the Kurdish minority on the death row.</s>
<s id="1:307">ڕۆژی شەممە 20ی بانەمەڕ، "هیدایەت عەبدوڵڵاپوور" بە بیانووی کارتی تەلەفۆن بۆ دەرەوەی بەندەکەی ڕاگوێزراوە و لە هۆکاری ڕاگواستنەوەکەی بۆ دەرەوەی بەند، هیچ زانیارییەک لەبەر دەستدا نییە.</s>	<s id="1:307">On Saturday, May 9, Hedayat Abdullahpour was taken out of the ward under the pretext of a phone card and then transferred to an unknown location.</s>
<s id="1:308">"هیدایەت عەبدوڵڵاپوور، پاش تەواوبوونی لێکۆڵینەوەکەی لە ڕێکەوتی 25ی ڕەزبەری ساڵی 95، بۆ زیندانی ورمێ ڕاگوێزرابوو.</s>	<s id="1:308">Hedayat Abdullahpour was transferred to Urmia Central Prison after the interrogation on October 16, 2016.</s>
<s id="1:309">مانگی ڕەشەمەی ساڵی 95ی هەتاوی، لقی 1ی دادگای ئینقلابی ورمێ، حوکمی ئێعدامی بە تۆمەتی "بغی و ئەندامبوون لە یەکێک لە حیزبە کوردییەکانی ئۆپۆزسیۆنی حکوومەتی ئێران"، بەسەر "هیدایەت عەبدوڵڵاپوور" سەپاند.</s>	<s id="1:309">On March 2016, this Kurdish political prisoner sentenced to death in the First Branch of the Revolutionary Court of Urmia on charges of " rebellion and membership in one of the Kurdish opposition parties in the Iranian government."</s>
<s id="1:310">ئەو حوکمە لە لقی 47ی دیوانی باڵای وڵات ڕەت کرابووەوە و دۆسیەی ئەو زیندانییە سیاسییە کوردە دووبارە ڕەوانەی لقی 2ی دادگای ئینقلابی ورمێ کرابوو.</s>	<s id="1:310">This verdict was violated in Branch 47 of the Supreme Court and his case was referred to the Second Branch of the Urmia Revolutionary Court for retrial.</s>
<s id="1:311">دادگاییکردنی دووبارەی ئەو زیندانییە سیاسییە مەحکووم کراوە بە ئێعدام، ڕێکەوتی 5ی بەفرانباری ساڵی 96، بە ئامادەبوونی نوێنەری دادستانی شاری ورمێ بەڕێوەچوو و ناوبراو بۆ دووهەمین کەڕەت بە ئێعدام مەحکووم.</s>	<s id="1:311">The retrial of this political prisoner sentenced to death was held on December 26, 2017 in the presence of a representative of the Urmia Prosecutor, and he was sentenced to death for the second time.</s>
<s id="1:312">دۆسیەی "هیدایەت عەبدوڵڵاپوور" پاش بڕینەوەی حوکمەکەی لە لقی دووی دادگای ئینقلابی ورمێ ڕەوانەی لقی 47ی دیوانی باڵای وڵات کرابوو و ڕۆژی دووشەممە 16ی ڕەزبەری ساڵی 97، پشتڕاست و حوکمی لەسێدارەدانی ئەو زیندانییە سیاسییە کوردە، بە پارێزەرەکەی ڕاگەیەندرا.</s>	<s id="1:312">Hedayat Abdullahpour's case was referred to Branch 47 of the Supreme Court after the ruling of the Second Branch of the Revolutionary Court of Urmia, and on Monday, October 8, 2018, the death sentence of this political prisoner was confirmed and his lawyer was notified.</s>
<s id="1:313">دۆسیەی ئەو زیندانییە سیاسییە کوردە، هەنووکە لە کۆمیسیونی لێبووردن و لێخۆشبوونی شاری ورمێدایە.</s>	<s id="1:313">The case of this political prisoner is currently in the Urmia Amnesty and Pardon Commission.</s>
<s id="1:314">ڕۆژی یەکشەممە 14ی بانەمەڕ، دوو هاووڵاتیی کوردی خەڵکی سنە، بە ناوەکانی "تارق ڕەحیم پوور" کوڕی "مووسا" و "بێنیامین ڕەحیم پوور" کوڕی "مووسا"، لەلایەن هێزە ئەمنییەتییەکانەوە دەسبەسەر کران و بۆ شوێنێکی نادیار ڕاگوێزران.</s>	<s id="1:314">On Sunday, May 3rd, two Kurdish citizens from Sanandaj, Tariq Rahimpour and Benjamin Rahimpour, sons of Musa, were detained by intelligence forces and taken to an unknown location.</s>
<s id="1:315">ئەو دوو هاووڵاتییە کوردە، بەبێ بەڵگەی یاسایی دەسبەسەر کراون و لە چارەنووسیان هیچ زانیارییەک لەبەر دەستدا نییە.</s>	<s id="1:315">These two citizens were detained without any legal permission and their fate is unknown.</s>
<s id="1:316">هەتا ئێستا بەدواداچوونی بنەماڵەی ئەو دوو هاووڵاتییە کوردە بۆ ئاگاداربوون لە چارەنووسیان بێئاکام ماوەتەوە و لە هۆکاری دەسبەسەرکردنیان هیچ زانیارییەک وەدەست نەکەوتووە.</s>	<s id="1:316">So far, the family's pursuits of these two citizens to find out about their fate have been fruitless, and the reason for their arrest has not been determined.</s>
<s id="1:317">ڕۆژی سێشەممە 23ی بانەمەڕ، کۆڵبەرێکی کورد بە ناوی "کامران مەولانیا" کوڕی "ئیسماعیل"، تەمەن 32 ساڵ و خەڵکی گوندی "گەوەڵان"ی سەردەشت بە تەقەی هێزە نیزامییەکانی حکوومەت گیانی لەدەست دا.</s>	<s id="1:317">On Tuesday, May 12, a Kurdish Kolbar named Kamran Molania, 32, son of Ismail, from the village of Guolan, was shot dead by Iranian government forces at the Sardasht's border.</s>
<s id="1:318">هێزە نیزامییەکانی حکوومەتی ئێران، ئەو کۆڵبەرە کوردەیان لەگەڵ ژمارەیەک لە کۆڵبەرانی دیکە، بەبێ ئاگادارکردنەوەی پێشوو داوەتە بەر دەسڕێژیی گوللە.</s>	<s id="1:318">Iranian government forces fired directly at this Kolbar and a group of Kolbars without any prior warning.</s>
<s id="1:319">"کامران مەولانیا" خێزاندار و باوکی کچێکی کەم تەمەنە.</s>	<s id="1:319">Kamran Molania is married and has one child.</s>
<s id="1:320">لەو پەیوەندییەدا، ئێوارەی ڕۆژی هەینی 19ی بانەمەڕ، ژمارەیەک لە کۆڵبەران لە سنووری "بلە سووری خوارێ" سەر بە شاری خۆی، لەلایەن هێزە نیزامییەکانی حکوومەتەوە تەقەیان لێ کراوە و لە ئەنجامی تەقەی ئەو هێزانە، کۆڵبەرێکی کورد بە ناوی "لوقمان چوارگوشە" گیانی لەدەست دا و دوو کۆڵبەری دیکە بە ناوەکانی "مەنسوور چوارگوشە و مەیسەم محەممەدی"، بەتوندی بریندار بوون.</s>	<s id="1:320">in this regard, on the evening of Friday, May 8, a group of Kurdish Kolbars were shot by Iranian government forces at the border of "Bolsur Sofla" in Khoy. One Kolbar "Loghman Chahargoosheh" was killed and two others named "Mansour Chahargoosheh and Meysam Mohammadi" were severely injured.</s>
<s id="1:321">سەر لەبەیانی ئەمڕۆ سێشەممە 9ی بانەمەڕ، زیندانییەک بە تاوانی "کوشتنی بە ئەنقەست" بە ناوی "فایەق شەریفی" خەڵکی شاری دیواندەرە لە زیندانی ناوەندی شاری سنە، لە سێدارە درا.</s>	<s id="1:321">This morning, Tuesday, April 28th, a prisoner accused of "murder" named "Fayeq Sharifi" from Divandarreh was executed in Sanandaj Central Prison.</s>
<s id="1:322">ئەو زیندانییە خەڵکی گوندی "تازاوا"ی شاری دیواندەرەیە و 5 ساڵ پێش بە تۆمەتی "کوشتنی بە ئەنقەست" دەسبەسەر دواتر بە قیسان مەحکووم کرا.</s>	<s id="1:322">This prisoner from the village of Tazehabad was arrested five years ago on charges of "premeditated murder" and sentenced to retribution (execution).</s>
<s id="1:323">لەلایەکی دیکەوە، ڕێکخراوی مافی مرۆڤی ئێران ڕایگەیاندووە کە سەر لەبەیانی ئەمڕۆ حوکمی لە سێدارەدانی زیندانییەک بە ناوی "یاسر ڕەسووڵی" خەڵکی شاری بۆکان لە زیندانی ناوەندیی ورمێ جێبەجێ کرا.</s>	<s id="1:323">The Human Rights Organization of Iran has also announced that the death sentence of a prisoner accused of "murder" named "Yaser Rasouli" from Bokan has been carried out in Urmia Central Prison this morning.</s>
<s id="1:324">ئەو زیندانییە بۆکانییە، ساڵی 90 بە تۆمەتی "کوشتنی بە ئەنقەست" دەسبەسەر کرابو و لەو کاتەوە هەتا کاتی لە سێدارەدانەکەی لە زیندان دابووە.</s>	<s id="1:324">This Bokani prisoner was arrested in 2011 on charges of "premeditated murder" and was being held in prison.</s>
<s id="1:325">دادگای ئینقلابی مەهاباد لاوێکی خەڵکی ئەو شارەی بە ناوی "بێهنام ئەلیاسی" کوڕی "فەتاح"ی بە دوو ساڵ زیندان مەحکووم کرد.</s>	<s id="1:325">Mahabad Revolutionary Court sentenced a young Kurd man named Behnam Eliasy, son of Fatah to two years in prison.</s>
<s id="1:326">دادگای ئینقلابی مەهاباد، ئەو لاوە کوردەی بە "لایەنگەری لە یەکێک لە حیزبە کوردییەکانی ئۆپۆزسیۆنی حکوومەتی ئێران" تۆمەتبار کردووە.</s>	<s id="1:326">The Mahabad Revolutionary Court has accused this young man of "supporting one of the Kurdish opposition parties in cyberspace".</s>
<s id="1:327">ئەو لاوە کوردە، ڕۆژی هەینی 14ی بەفرانبار، پاش ئازار و ئەشکەنجەدانی لەلایەن هێزە ئیتلاعاتییەکانەوە، بەبێ بەڵگەی یاسایی دەسبەسەر کرابوو.</s>	<s id="1:327">This young Kurd was arrested on Friday, July 5, 2019, after being beaten by security forces without a legal permit.</s>
<s id="1:328">پێنج هاووڵاتیی کورد بە ناوەکانی: "سەید ئەحمەد سەبری خەڵکی پەسوێ، عەبدوڵڵا حەسەنزادە خەڵکی پەسوێ، محەممەد ئیبراهیمزادە خەڵکی گوندی خورنج، محەممەد ئەلیاسی کوڕی محەممەد تاهیر خەڵکی نەغەدە و سەلام بارزگانی خەڵکی پەسوێ"، پاش دەسبەسەرکرانیان لەلایەن هێزە ئیتلاعاتییەکانەوە بۆ لێپرسینەوە ڕەوانەی گرتنگەی ڕێکخراوی ئیتلاعاتی سپای پاسداران لە ورمێ کراون.</s>	<s id="1:328">Five Kurdish citizens named as "Sayed Ahmad Sabri", from Pasveh," Abdullah Hasanzadeh" from Pasveh, "Mohammad Ebrahimzadeh", from the Village of Khoranj, "Mohammad Eliasi" son of Mohammad Tahir, from Naqadeh, "Salam Bazargani", from Pasveh, have been transferred to the Urmia Sepah Detention center after being arrested.</s>
<s id="1:329">ئەو 5 هاووڵاتییە کوردە، ڕۆژی یەکشەممەی ڕابردوو، بەبێ بەڵگەی یاسایی لەلایەن هێزە ئیتلاعاتییەکانەوە دەسبەسەر کرابوون.</s>	<s id="1:329">These five Kurdish citizens were detained on Sunday, March 1st, by the intelligence agents without any legal permission.</s>
<s id="1:330">هەروەها، هاووڵاتییەکی دیکەی کورد بە ناوی "سەید مستەفا سەبری"، تەمەن 70 ساڵ و خەڵکی پەسوێ، پاش چەند کاتژمێر دەسبەسەری لەلایەن هێزە ئیتلاعاتییەکانەوە ئازاد کرابوو و هەروەها عەبدوڵڵا حەسەنزادە پاش دوو ڕۆژ لە ئازاد کرانی لە گرتنگە، دووبارە لەلایەن هێزە ئیتلاعاتییەکانەوە دەسبەسەر و بۆ گرتنگەی ئیتلاعاتی سپای پاسداران لە ورمێ ڕاگوێزرابوو.</s>	<s id="1:330">Also, a Kurdish citizen named "Sayed Mustafa Sabri", a 70-year-old from Pasveh, was released after few hours of detention by the intelligence agents, and Abdullah Hassanzadeh was re-arrested by the intelligence forces after two days of detention and taken to the Revolutionary Guards Intelligence detention center and he has been relocated to Urmia Ettelaat Bureau.</s>
<s id="1:331">هێزە ئیتلاعاتییەکان لە کاتی دەسبەسەرکردنی ئەو هاووڵاتییانە، دەستیان بەسەر هەندێک کەرەستەی ئەواندا گرت و لەگەڵ خۆیان بردبوویان.</s>	<s id="1:331">Intelligence forces confiscated some of their personal belongings while detaining them.</s>
<s id="1:332">هەتا کاتی بڵاوبوونەوەی ئەم هەواڵە، لە تۆمەتی وەپاڵدراوی ئەو 5 هاووڵاتییە کوردە زانیارییەکی ورد لەبەر دەستدا نییە.</s>	<s id="1:332">No exact information is available on the charges against these five Kurdish citizens.</s>
<s id="1:333">وێنە: محەممەد ئیبراهیمزادە، سەید ئەحمەد سەبری، سەلام بازرگانی، عەبدوڵڵا حەسەنزادە و محەممەد ئەلیاسی</s>	<s id="1:333">Photo: Mohammad Ebrahimzadeh, Sayed Ahmad Sabri, Salam Bazargani, Abdullah Hassanzadeh, Mohammad Eliasi</s>
<s id="1:334">ڕۆژی یەکشەممە 27ی ڕێبەندان، زیندانییانی زیندانی ورمێ، داوایان لێکراوە بەشداری لە 11یەمین خولی هەڵبژاردنەکانی مەجلیسدا بکەن.</s>	<s id="1:334">On Monday, March 30th, a Kurdish citizen named "Rahim Hassan Mahali", 50, son of Karim from Piranshahr, was transferred to ward three of Urmia Prison after serving two weeks in quarantine.</s>
<s id="1:335">سەر لەبەیانی ئەمڕۆ سێشەممە 9ی بانەمەڕ، زیندانییەک بە ناوی "زورار پەیغامی" خەڵکی شاری شنۆ، بە تاوانی "کوشتنی بە ئەنقەست" لە زیندانی ورمێ لە سێدارە درا.</s>	<s id="1:335">This morning, Tuesday, April 28th, a prisoner accused of "murder" named "Zourar Peyghami" from Oshnavieh was executed in Urmia Prison.</s>
<s id="1:336">ئەو زیندانییە سێ ساڵ پێش لە ئەنجامی شەڕ و دەمەقاڵێدا، بوو بەهۆی کوشتنی هاووڵاتییەک بە ناوی "کاوە مەعرووفی".</s>	<s id="1:336">This prisoner killed a citizen named "Kaveh Maroufi" three years ago in a personal dispute.</s>
<s id="1:337">هەوڵەکانی چالاکانی مەدەنی، مامۆستایانی ئایینی و هاووڵاتییانی شاری شنۆ، بۆ وەرگرتنی ڕەزایەت لە بنەماڵە کوژراوەکە بۆ لێخۆشبوونی لە ئێعدامکردنی زورار پەیغامی بێ ئاکام مایەوە و بنەماڵەی کوژراوەکە، داخوازیی هاووڵاتییانیان بۆ لێخۆشبوونی ئەو هاووڵاتییە کوردە، ڕەتکردەوە.</s>	<s id="1:337">Attempts by Oshnavieh's clerics and civil activists to obtain the victim's consent to prevent the execution of the prisoner were unsuccessful, and the victim's family rejected the request for amnesty and pardon.</s>
<s id="1:338">لەو پەیوەنییەدا، ڕۆژی دووشەممە 8ی بانەمەڕ، زیندانییەک بە ناوی "کەیوان ئەڵڵامورادی" خەڵکی گوندی "بڵواناوا"ی شاری دێولان، بە تاوانی "کوشتنی بەئەنقەست" لە زیندانی ناوەندیی سنە لەسێدارە درا.</s>	<s id="1:338">In this regard, on the morning of Monday, April 27th, a prisoner accused of "murder" named "Keyvanullah Moradi", 28, resident of the village of "Balbanabad", Dehgolan, was executed in Sanandaj Central Prison.</s>
<s id="1:339">لە ماوەی ڕۆژانی ڕابردوو، لاوێکی کورد بە ناوی "ئالان بەنگین" تەمەن 21 ساڵ و خەڵکی گوندی "کانی ڕەش"ی شنۆ، لە کاتی سەربازیدا لەلایەن هێزە ئەمنییەتییەکانەوە دەسبەسەر کرا و بۆ شوێنێکی نادیار ڕاگوێزرا.</s>	<s id="1:339">In recent days, a young Kurdish man named Alan Bangin, 21, from the village of Kani Rash in Oshnavieh, was arrested by intelligence forces during his military service and taken to an unknown location.</s>
<s id="1:340">پاش دەسبەسەرکردنی ئەو لاوە کوردە، لاوێکی دیکەی خەڵکی ئەو گوندە بە ناوی "یەحیا ئیبراهیمی" تەمەن 20 ساڵ، لەلایەن هێزە ئەمنییەتییەکانەوە دەسبەسەر کراوە و ئەویش بۆ شوێنێکی نادیار ڕاگوێزراوە.</s>	<s id="1:340">Following the arrest of this young man, another young man from the village of Kani Rash, Yahya Ebrahimi, 21, was arrested by intelligence forces forces and taken to an unknown location.</s>
<s id="1:341">هێزە ئەمنییەتییەکان هێرشیان کردووەتە سەر ماڵی ئەو هاووڵاتییە کوردە لە گوندی کانی ڕەش و دەستیان بە پشکنینی ماڵی ناوبراو کردووە و هەروەها هەندێک کەرەستەی وەک کامپیۆتێری ئەو هاووڵاتییەیان لەگەڵ خۆیان بردووە.</s>	<s id="1:341">Intelligence forces raided his family's home in the village of Kani Rash, and after searching his home, some of his personal belongings, including his computer, were confiscated and taken away.</s>
<s id="1:342">هەتا کاتی بڵاوبوونەوەی ئەم هەواڵە لە هۆکاری دەسبەسەرکردن و شوێنی ڕاگیرانی ئەو دوو لاوە کوردە هیچ زانیارییەک لەبەر دەستدا نییە.</s>	<s id="1:342">No information is available on the reason for the arrest or whereabouts of the two Kurdish youths.</s>
<s id="1:343">ڕۆژی سێشەممە 27ی ڕەشەمەی 98، لاوێکی کورد بە ناوی "ڕەزا عوسمانی" خەڵکی شاری مەریوان، لە کاتی بەڕێوەبردنی ڕێوڕەسمی چوارشەممەسووری لەلایەن هێزە ئیتلاعاتییەکانەوە دەسبەسەر کرا.</s>	<s id="1:343">On Tuesday, March 17th, 2020, a Kurdish young man, Reza Osmani, from Marivan, was arrested by intelligence forces during Showarshama Sori ceremony.</s>
<s id="1:344">هێزە ئیتلاعاتییەکان ئەو لاوە کوردەیان بە تاوانی "هەڵگرتنی ئاڵای کوردستان" دەسبەسەر کردووە و بۆ شوێنێکی نادیار ڕاگوێزراوە</s>	<s id="1:344">Intelligence forces arrested this young man on charges of "raising the Kurdistan flag" and transferred him to an unknown location.</s>
<s id="1:345">هەتا ئێستا بەدواچوونی بنەماڵەی ئەو هاووڵاتییە کوردە، بۆ ئاگاداربوون لە چارەنووسی کوڕەکەیان بێئاکام بووە.</s>	<s id="1:345">So far, the Kurdish citizen's family's follow-up for his fate has not yielded any results.</s>
<s id="1:346">لەو پێووەندییەدا، ڕۆژی سێشەممە 27ی ڕەشەمەی ساڵی 98، هاووڵاتییەکی کورد بە ناوی "محەممەد عوبیدی" خەڵکی مەریوان لە کاتی بەڕێوەبردنی ڕێوڕەسمی چوارشەممە سووری لە لایەن هێزە ئیتلاعاتییەکانەوە بە هۆی هەڵگرتنی ئاڵای کوردستان، دەسبەسەر کرابوو.</s>	<s id="1:346">In this regard, on Tuesday, March 17th, a Kurdish citizen named "Mohammed Obeidi" from Marivan was arrested by intelligence agents due to raising the Kurdistan flag in Showarshama Sori ceremony.</s>
<s id="1:347">دادگای ئینقلابی سنە سێ ساڵ زیندانیی بەسەر "سیروان ئیبراهیمی"، بەرپرسی لقی ئەنجومەنی فەرهەنگی- کۆمەڵایەتیی "نۆژین" لە شاری کامیاران سەپاند.</s>	<s id="1:347">The Sanandaj Revolutionary Court has sentenced Sirvan Ebrahimi, the head of Nojin Socio-cultural Association in Kamyaran's branch, to three years in prison.</s>
<s id="1:348">دادگای ئینقلابی سنە ئەو مامۆستایەی زمانی کوردیی بە "ئەندامبوون لە گرووپە دژبەرەکانی نیزام و هەواڵدان دژی تەناهی نەتەوەیی" تاوانبار کردووە.</s>	<s id="1:348">The Sanandaj Revolutionary Court has charged this Kurdish teacher with "joining the opposition and acting against national security."</s>
<s id="1:349">بەرپرسی لقی ئەنجومەنی فەرهەنگی- کۆمەڵایەتیی "نۆژین" لە کامیاران، ڕۆژی پێنجشەممە، 21ی خەرمانانی ئەمساڵ، بە دانانی بارمتەی 500 ملیۆن تمەنی بە شێوەی کاتی لە گرتنگە ئازاد کرابوو.</s>	<s id="1:349">The head of the Nojin Socio-cultural Association in Kamyaran's branch was released on 500 million Toman bail on Thursday, September 12th.</s>
<s id="1:350">ئەو چالاکە مەدەنییە کوردە، ئێوارەی ڕۆژی چوارشەممە، 5ی پووشپەڕ، بەبێ بەڵگەی یاسایی لەلایەن هێزە ئیتلاعاتییەکانەوە دەسبەسەر کرابوو.</s>	<s id="1:350">This Kurdish activism was detained on Wednesday night, July 26th, without any legal permission by the intelligence agents.</s>
<s id="1:351">ڕۆژی سێشەممە 27ی ڕەشەمە، کۆڵبەرێکی کورد بە ناوی "سەیوان شەریفی" کوڕی "خالید"، خەڵکی بانە، لە سنووری "هەنگەژاڵ"ی ئەو شارە، بە تەقەی هێزە نیزامییەکانی حکوومەت گیانی لەدەست دا.</s>	<s id="1:351">On Tuesday, March 17th, a Kurdish Kolbar named "Sewan Sharifi", son of Khaled, from Baneh, died at the border of the city's "Hanga zhal" after government troops fired on him.</s>
<s id="1:352">ئەو کۆڵبەرە کوردە بەبێ ئاگادارکردنەوەی پێشوو لەلایەن هێزە نیزامییەکانەوە تەقەی لێ کرابوو.</s>	<s id="1:352">This Kurdish Kolbar has been targeted by government troops from close range without any warning.</s>
<s id="1:353">تەرمی ئەو کۆڵبەرە ڕەوانەی پزیشکی یاسایی بانە کراوە و هەتا ئێستا ڕادەستی بنەماڵەکەی نەکراوەتەوە.</s>	<s id="1:353">The body of this Kurdish Kolbar was transferred to Baneh Forensic Medicine and has not yet been handed over to his family.</s>
<s id="1:354">لەو پەیوەندییە و لە ماوەی ڕۆژانی ڕابردوودا، کۆڵبەرێکی کورد بە ناوی "محەممەد قادری" لە بەرزاییەکانی سنووری سەردەشت، بە تەقەی هێزەکانی سپای پاسداران بریندار کرابوو.</s>	<s id="1:354">In this regard, in recent days, a Kurdish Kolbar, "Mohammad Qaderi", was severely injured in the Sardasht border crossing following by the direct firing of Revolutionary Guards.</s>
<s id="1:355">ڕۆژی هەینی 2ی ڕەشەمە، هاووڵاتییەکی کورد بە ناوی "عەبدوڵڵا سادقی" خەڵکی شاری سەرپێڵیزەهاو، لەلایەن هێزە ئیتلاعاتییەکانەوە، دەسبەسەر کرا و بۆ شوێنێکی نادیار ڕاگوێزرا.</s>	<s id="1:355">On Friday, February 21st, a Kurdish citizen, Abdullah Sadeghi, was arrested by intelligence forces and taken to an unknown location.</s>
<s id="1:356">دەسبەسەرکردنی ئەو هاووڵاتییە کوردە، بەبێ بەڵگەیی یاسایی بووە و هێزە ئیتلاعاتییەکان ناوبراویان بە تۆمەتی "بانگەشە بۆ بایکۆتی هەڵبژاردنەکان" تاوانبار کردووە.</s>	<s id="1:356">This Kurdish young man was arrested without legal authorization and intelligence officials accused him about "propaganda against boycotting the elections".</s>
<s id="1:357">هەتا ئێستا بەدواداچوونی بنەماڵەی ئەو هاووڵاتییە کوردە، بۆ ئاگاداربوون لە چارەنووسی کوڕەکەیان بێئاکام ماوەتەوە.</s>	<s id="1:357">So far, the citizen's family has been unsuccessful in finding out about his fate.</s>
<s id="1:358">ڕۆژی چوارشەممە 31ی بانەمەڕ، لاوێکی کورد بە ناوی "شەهاب ئاجی" کوڕی "حوسێن"، تەمەن 23 ساڵ و خەڵکی گوندی "گەرگول" و دانیشتووی نەغەدە، پاش بانگهێشتکردنی بۆ ئیدارەی ئیتلاعات ورمێ، دەسبەسەر کراوە.</s>	<s id="1:358">On Wednesday, May 20, a young Kurdish man named Shahab Aji, 23, son of Hussein from the village of Gargol in Naqadeh, was arrested after being summoned to the Urmia Intelligence Bureau.</s>
<s id="1:359">ئەو لاوە کوردە بۆ لێپرسینەوە ڕەوانەی گرتنگە کراوە و هیچ زانیارییەک لەمەڕ چارەنووسی لەبەر دەستدا نییە.</s>	<s id="1:359">This young Kurd was taken to a detention center for questioning, and his exact fate is unknown.</s>
<s id="1:360">لە ماوەی ڕابردوودا، ناوەندە ئەمنییەتییەکان چەندین جار ئەو لاوە کوردەیان بانگهێشت کردووە و لێپرسینەوەیان لێکردبوو.</s>	<s id="1:360">This young man has been constantly summoned to security agencies recently.</s>
<s id="1:361">هەتا کاتی بڵاوبوونەوەی ئەم هەواڵە، لە هۆکاری دەسبەسەرکردنی ئەو لاوە کوردە هیچ زانیارییەک لەبەر دەستدا نییە.</s>	<s id="1:361">Until the moment of publication of this news, no information is available on the reason for the arrest of this Kurdish citizen.</s>
<s id="1:362">ڕۆژی پێنجشەممە 1ی جۆزەردان، هێزە نیزامییەکانی حکوومەتی جێگیر لە پایگای "بێتووش" ژمارەیەک لە کۆڵبەرانی کورد لە سنووری ئەو شارەیان دایەبەر دەسڕیژی گوللە.</s>	<s id="1:362">On Thursday, May 21, Iranian government forces stationed at the Bitush base targeted a group of Kurdish Kolbars at the Sardasht border.</s>
<s id="1:363">لە ئەنجامی تەقەی هێزە نیزامییەکانی حکوومەتی، دوو کۆڵبەری کورد بە ناوەکانی "مەنسوور ئیسماعیلی" تەمەن 30 ساڵ خەڵکی گوندی "باغی" و "بەختیار حەسەننژاد" تەمەن 32 ساڵ خەڵکی گوندی "شەڵماش"ی شاری سەردەشت پێکران.</s>	<s id="1:363">Following the firing of government troops, two Kurdish Kolbars, Mansour Ismaili, 30, from Baghi village, and Bakhtiar Qaderian, 32, from the village of Shalmash in Sardasht, were seriously injured.</s>
<s id="1:364">ئەو دوو کۆڵبەرە کوردە، بەهۆی بەرکەوتنی گوللەی هێزە نیزامییەکان، لە نێوقەدەوە تووشی برینی قورس بوونه.</s>	<s id="1:364">due to the bullets, these two Kurdish Kolbars were severely wounded in the back.</s>
<s id="1:365">ئەو دوو کۆڵبەرە کوردە، بۆ چارەسەری پزیشکی ڕەوانەی ناوەندی دەرمانی شاری سەردەشت کراون.</s>	<s id="1:365">These two Kolbars were taken to Sardasht Medical Center for medical treatment.</s>
<s id="1:366">ڕۆژی سێشەممە 27ی ڕەشەمەی 98، هاووڵاتییەکی بە ناوی "محەممەد عوبیدی" خەڵکی شاری مەریوان لەلایەن هێزە ئیتلاعاتییەکانەوە دەسبەسەر کرا.</s>	<s id="1:366">On Tuesday, March 17th, a Kurdish citizen, Mohammed Obaidi, from Marivan, was arrested by intelligence forces.</s>
<s id="1:367">ئەو هاووڵاتییە کوردە، لە کاتی بەرڕوەبردنی ڕێوڕەسمی چوارشەممەسووری، بەهۆی هەڵگرتنی ئاڵای کوردستان دەسبەسەر کراوە.</s>	<s id="1:367">This Kurdish citizen was arrested during a ceremony of Showarshama Sori for raising the flag of Kurdistan.</s>
<s id="1:368">هێزە ئیتلاعاتییەکان پاش دەسبەسە کردنی ئەو هاووڵاتییە کوردە، ناوبراویان بۆ شونێکی نادیار ڕاگواستووە.</s>	<s id="1:368">Intelligence forces transformed him to an unknown location after his arrest.</s>
<s id="1:369">هەتا ئێستا بەدواچوونی بنەماڵەی ئەو هاووڵاتییە کوردە، بۆ ئاگاداربوون لە چارەنووسی کوڕەکەیان، بێئاکام ماوەتەوە.</s>	<s id="1:369">So far, the Kurdish citizen's family's pursuit about his fate has been fruitless.</s>
<s id="1:370">ڕۆژی پێنجشەممە 22ی ڕەشەمە، لاوێکی کورد بە ناوی "خەبات محەممەدی" خەڵکی شاری سنە، لە لایەن هێزە لیباس شەخسییەکانەوە، دەسبەسەر کرا.</s>	<s id="1:370">On Thursday, March 12, a Kurdish youth named Khabat Mohammadi, from Sanandaj was arrested by plainclothes forces.</s>
<s id="1:371">ئەو لاوە کوردە، پاش دەسبەسەرکرانی بۆ شوێنێکی نادیار ڕاگوێزراوە و لە چارەنووسی هیچ زانیارییەک لە بەردەستدا نییە.</s>	<s id="1:371">This young Kurd was taken to an unknown location after his arrest and his fate is not known.</s>
<s id="1:372">هێزە لیباس شەخسییەکان ئەو لاوە کوردەیان بە تۆمەتی "ئەندامبوون لە یەکێک لە حیزبە کوردییەکانی دژبەری حکوومەتی ئێران" دەسبەسەر کردووە.</s>	<s id="1:372">Plainclothes officials have called the arrest of the young man "a member of one of the Kurdish opposition parties of the Iranian government".</s>
<s id="1:373">ئەو چالاکە کوردە بە "هاوکاری لەگەڵ یەکێک لە حیزبە کوردییەکانی ئۆپۆزسیۆنی حکوومەتی ئێران" تۆمەتبار کراوە.</s>	<s id="1:373">This environmental activist was arrested without any permission and was transferred to an unknown location.</s>
<s id="1:374">لەو گوتارەدا، کە لە ژێر ناوی \"باڵوێزخانەی ئامریکا لە هەولێر؛ پێشەنگی هەوڵدانە بۆ نارامکردنی سنوورەکانی ڕۆژئاوای ئێران\" بڵاوی کردووەتەوە، تێدا هاتووە: \"هاوکات لەگەڵ بەهێزبوونی ئەگەرەکان لە بارەی هەوڵی واشنگتۆن بۆ نائارامکردنی سنوورەکانی ڕۆژئاوای ئێران، دەوڵەتی ئامریکا، کارناسێکی بە پێشینەی لە سەر پرسی ئێران وەکوو کونسوڵی نوێی وڵاتەکەی لە شاری هەولێر دیاری کرد.</s>	<s id="1:374">The commentary titled ‘the United States Consulate in Erbil is the first source of destabilizing the Iran’s west borders’ reads: “At the time the likelihood of destabilizing the Iran’s west borders by the Washington administration is so high, the US government appointed an experienced expert (Steven Fagin) on the Kurdish question as the US consul in Erbil.</s>
<s id="1:375">لێرەدا خاڵی جێگای سەرنج ئەوەیه کە لە ڕەوتی دیداری مستەفا هیجری بۆ واشنگتۆن، فیگین یەکێک لە بەرپرسانی ئامریکا بووە کە لەو دیدارەدا لەگەڵ ناوبراو وتووێژی کردبوو\".</s>	<s id="1:375">It is noticeable that during the Mustafa Hijri’s visit to Washington, Fagin was one of the US officials who met him’.</s>
<s id="1:376">لەو گوتارەدا، ئاماژە بە سەردانی لێپرسراوی گشتیی \"حدکا\" بۆ ئامریکا دەکات، نووسیوویەتی: \"بەپێی ئەم ڕاپۆرتە، \"مستەفا هیجری\"، ڕێبەری گرووپی \"حدکا\"، ڕۆژانی 11هەتا 17 ژوئەن(21 هەتا 27پووشپەڕ) سەردانی واشنگتۆنی کردەوە و لەگەڵ بەرپرسانی وەزارەتی دەرەوەی ئامریکا، ئەندامانی کۆنگرە و کارناسانی ئەندێشکەدەکان چاوپێکەوتنی کردووە.</s>	<s id="1:376">Mentioning the recent visit of the Democratic Party of Iranian Kurdistan’s leader to the United states, it reads: “Mustafa Hijri, the PDKI’s leader visited Washington and met some of the US Department of State’s officials, congressmen and think tank’s scholars from 11 to 17 June.</s>
<s id="1:377">لەو گوتارەدا، چالاکییەکانی حیزبە کوردییەکانی ئۆپۆزسیۆنی حکوومەتی ئێرانیان بە ئامریکا نیسبەت داوە و حکوومەتی ئێران، ئامریکای بە پشتیوانیی نیزامیی_ماڵی لەم حیزبە تاوانبار دەکات.</s>	<s id="1:377">The commentary claims that the United States was behind the Iranian Kurdish opposition groups and reports that the Iranian government accused America of providing those groups with financial, military supports.</s>
<s id="1:378">ئاژانسی کوردپا لەو پەیوەندییەدا، لەگەڵ "کەریم پەرویزی"، ئەندامی دەستەی کارگێڕیی حدکا، وتووێژێکی کورتی لەو پەیوەندییەدا ئەنجام داوە.</s>	<s id="1:378">To discuss this topic, Kurdpa News Agency has briefly interviewed Karim Parwizi, a member of the PDKI’s Executive Board.</s>
<s id="1:379">کەریم پەرویزی: ڕێژیمی ئێران هەردەم چالاکیی هەموو خەڵکی ئێران و بەتایبەت خەباتی کوردی لە پێناوی مافە سروشتیەکانیاندا، بە دەسکردی بیانی ناو بردوە.</s>	<s id="1:379">Karim Parwizi: The Iranian regime has always claim that the foreign countries are behind the Iranian people’s activities especially the Kurdish movement to achieve their primary rights.</s>
<s id="1:380">ئەو جۆرە ئیدیعایانە شتێکی نوێ نین و چل ساڵە پروپاگەندەی لەو چەشنە دەکا.</s>	<s id="1:380">Those claims aren’t something new since they have been repeated for forty years.</s>
<s id="1:381">سەردەمانێک چالاکیی کوردی بە هاندراوی ئێمپریالیزم و سەهیوونیزم و یەکیەتیی سۆڤیەت و ... ئەو شتانە دەزانی!</s>	<s id="1:381">In early years, it claimed that the Kurdish movement was under the influence of Imperialism, Zionism and the Soviet Unions and other political blocks.</s>
<s id="1:382">لە کاتێکدا ئەو چەند بەرەی دژ بەیەک بوون!</s>	<s id="1:382">Whereas as we know most of them were against each other.</s>
<s id="1:383">ئاژانسی کوردپا: ئایا ئامریکا پشتیوانی لە چالاکییەکانی ئێوە دەکات؟</s>	<s id="1:383">Kurdpa Agency: Does the United States support your activities?</s>
<s id="1:384">کەریم پەرویزی: ئێمە داوا لە دەوڵەت و نەتەوە و ڕێکخراوە مەدەنیەکانی ئامریکا و وڵاتانی دێموکراتیکی جیهان و ئەو هێزانەی کە خەمی ئازادی و دادپەروەییان هەیە کردوە و دەکەین کە یارمەتیدەرمان بن بۆ گەیشتن بە ئازادی.</s>	<s id="1:384">Karim Parwizi: We have been asking the United States’ government, America’s nation, American’s NGOs as well as all the democratic countries and any force supporting liberal and social movements to help us in our fighting to bring about freedom.</s>
<s id="1:385">تا ئێستاش بەداخەوە پشتیوانیەکی ئەوتۆ لە لایەن دەوڵەتی ئامریکاوە و بۆ خەباتی کورد لە کوردستانی ڕۆژهەڵات نەکراوە.</s>	<s id="1:385">Unfortunately, the US government hasn’t still come up to our expectation to support the Kurdish movement in the Iranian Kurdistan.</s>
<s id="1:386">ئەوە بە ڕەخنەیەک لە سەر ئامریکا و دەوڵەتەکەی دەزانین کە دەبێ یارمەتیدەری گەلان بۆ گەیشتن بە ئازادی و ئاشتییەکی دادپەروەرانە بێ.</s>	<s id="1:386">We criticize the US in that it is expected to help other nations in their struggle to achieve freedom as well as stable peace.</s>
<s id="1:387">ئێمە ئەگەر ئامریکا و هەر وڵاتێکی دیکە پشتیوانیمان بکا، پێشوازی لێ دەکەین.</s>	<s id="1:387">We greatly appreciate receiving any support from the United States or any other country.</s>
<s id="1:388">کۆماری ئیسلامی گرووپە تیرۆریستیەکانی وەکوو حیزبوڵڵا بار دێنێ و بۆ سەرکوتی خەڵکانی ئێران کەڵکیان لێوەر دەگرێ، یان لە پێناوی مانەوەی ڕێژیمە تاوانبارەکەیدا هەموو وڵاتی بە ڕووسیە و چین و ... هەرزانفرۆش دەکا.</s>	<s id="1:388">The Islamic Republic of Iran uses some terrorist groups like Hezbollah to suppress the Iranian people and plunder Iranian wealth to win the support of some countries like China and Russia in order to stay in power.</s>
<s id="1:389">گەلان و نەتەوەکانی ئێرانیش مافی خۆیان بۆ خەباتەکەیان دژ بە سەرەرۆیی ستەمکاریی کۆماری ئیسلامی پشتیوان بۆ خۆیان پەیدا بکەن.</s>	<s id="1:389">Therefore, the Iran’s suppressed nations have the right to find help and support for their struggle against this suppressing regime.</s>
<s id="1:390">ئاژانسی کوردپا: ئێران ئیدعا دەکات کە پلانی چالاکییەکانی حیزبەکانی ڕۆژهەڵات لە کۆنسوولگەریی ئامریکا لە هەولێر دادەڕشترێت، تا چەندە ئەمە ڕاستە؟</s>	<s id="1:390">Kurdpa Agency: Iran claims that it is the US Consulate in Erbil that is planning the Rojhelat parties’ activities. Is it true?</s>
<s id="1:391">کەریم پەرویزی: ئێمە هیوادارین کە کۆنسوولگەری و وەزارەتی دەرەوەی ئامریکا و وڵاتانی دیکەش پشتیوانیی سیاسی لە خەباتی کورد لە کوردستانی ڕۆژهەڵات بکەن.</s>	<s id="1:391">Karim Parwizi: Even though we are looking forward to being politically supported by different sides whether it is the US Consulate, the US Department of State or any other side.</s>
<s id="1:392">پلانی جموجۆڵی پێشمەرگە و تاکتیک و ستراتژیی نیزامی و سیاسی، بۆ خۆمان دایدەڕێژین و کەس بۆمانی دیاری ناکا!</s>	<s id="1:392">The Peshmerga activities and Peshmerga political-military tactics and strategies are planned by us not anybody else.</s>
<s id="1:393">پاش چالاکییەکانی حیزبی دێموکرات لە ڕۆژهەڵات، سپای پاسداران و بەرپرسانی ئێرانی دەستیان کردووە بە هەڕەشەی لە نێوبردنی حیزب.</s>	<s id="1:393">Following the PDKI’s intensive activities in Rojhelat, the IRGC’s top officials and officials from different state organizations in Iran threatened to destroy the party.</s>
<s id="1:394">کورد لە کوردستانی ڕۆژهەڵات گەر لە هەڕەشە بترسایە و چاوترسێن بکرایە، دوای فەرمانی جەهادی خومەینیی تاوانبار بە دژی کورد، وازی لە خەبات دەهێنا و چۆکی دادەدا!</s>	<s id="1:394">If the regime had succeeded in terrifying the Kurds in East Kurdistan, we couldn’t have seen the continuation of this nation’s movement and it might have surrendered after Khomeini issued Fatwa against this nation.</s>
<s id="1:395">چل ساڵە کوردستان بەپێوەیە و کورد خەبات دەکا و چاوترسێن نەبووە و نابێ.</s>	<s id="1:395">The Kurdish nation has been fighting the regime for four decades.</s>
<s id="1:396">لە ماوەی ڕۆژانی ڕابردوودا، هاووڵاتییەکی کورد بە ناوی "عوبەید عزیزنژاد"، خەڵکی کرماشان، لەلایەن هێزە ئیتلاعاتییەکانەوە دەسبەسەر کرا و بۆ شوێنێکی نادیار ڕاگوێزرا.</s>	<s id="1:396">In recent days, a Kurdish citizen, Obaid Aziz Nejad, from Kermanshah, has been detained by intelligence forces and taken to an unknown location.</s>
<s id="1:397">دەسبەسەرکردنی ئەو هاووڵاتییە کرماشانییە بەبێ بەڵگەی یاسایی بووە و بەدواداچوونی بنەماڵەی ناوبراو بۆ ئاگاداربوون لە چارەنووسی هەتا ئێستا بێئاکام بووە.</s>	<s id="1:397">This Kermanshahi citizen was arrested without legal authorization and so far his family has been unsuccessful in finding out about his fate.</s>
<s id="1:398">بە وتەی سەرچاوەیەکی ئاگادار، هێزە ئیتلاعاتییەکان "عوبەید عزیزنژاد"یان بە تۆمەتی "هاوکاری لەگەڵ یەکێک لە حیزبە کوردییەکانی ئۆپۆزسیۆنی حکوومەتی ئێران" دەسبەسەر کردووە.</s>	<s id="1:398">According to a source, intelligence forces have arrested this Kurdish citizen on charges of "cooperating with one of the Kurdish opposition parties of the Iranian government."</s>
<s id="1:399">چەند ڕۆژ پێش هاووڵاتییەکی کوردی خەڵکی کرماشان بە ناوی "ئیسماعیل مەنسووری" لەلایەن هێزە ئیتلاعاتییەکانەوە دەسبەسەر کراوە.</s>	<s id="1:399">A few days ago, a Kurdish citizen from Kermanshah, Ismail Mansouri, was arrested by intelligence forces.</s>
<s id="1:400">هێزە ئیتلاعاتییەکان ئەم هاووڵاتییە کوردەیان بەبێ پیشاندانی مۆڵەتی یاسایی لە ڕێگای داڵاهۆ- کرماشان دەسبەسەر کردووە.</s>	<s id="1:400">Intelligence forces have arrested this Kurdish citizen on the Dalahoo-Kermanshah Road without legal authorization.</s>
<s id="1:401">تا کاتی بڵاوبوونەوەی ئەم هەواڵە، لە چارەنووس و هۆکاری دەسبەسەرکردنی ئەم هاووڵاتییە هیچ زانیارییەک لەبەر دەستدا نییە.</s>	<s id="1:401">No information is available on the fate and the reasons of this detention of this Kurdish citizen.</s>
<s id="1:402">ئێوارەی ڕۆژی شەممە 26ی بانەمەڕ، هێزە نیزامییەکانی تورکیە بە تەقەکردن لە ژمارەیەک لە کۆڵبەرانی کورد لە سنووری قوتووری خۆی، کۆڵبەرێک بە ناوی "بەهرام یووسفی" تەمەن 35 ساڵ خەڵکی گوندی "بەلەجووک" گیانی لەدەست دا و کۆڵبەرێکی دیکە بە ناوی "شەمسەدین عومەرپوور" بە سەختی پێکرا.</s>	<s id="1:402">On Saturday evening, May 17, Turkish troops opened fire on a group of Kurdish Kolbars on the Qotur border in Khoy, one Kolbar, Bahram Yousefi, 35, from the village of Beljuk, was killed and another kolbar named Shemsaldin Omarpour was seriously injured.</s>
<s id="1:403">ئەو دوو کۆڵبەرە کوردە لە بەرزاییەکانی سنووری قوتوور کرانە ئامانجی تەقەی هێزە نیزامییەکانی تورکیە و ڕەوانەی نەخۆشخانەی ''وان''ی تورکیە کراون.</s>	<s id="1:403">These two Kolbars were shot by Turkish troops in the highlands of Qotur and taken to Van Turkish Hospital.</s>
<s id="1:404">هەتا ئێستا تەرمی ئەو کۆڵبەرە کوژراوە ڕادەستی بنەماڵەکەی نەکراوە.</s>	<s id="1:404">kolbar's body has not yet been returned to his family.</s>
<s id="1:405">ناوبراو خێزاندار و باوکی چوار منداڵە.</s>	<s id="1:405">He is married and has four children.</s>
<s id="1:406">لە درێژەی دەسبەسەرکردنی هاووڵاتییانی کورد لە پیرانشار، ڕۆژی سێشەممە 16ی بانەمەڕ، 5 هاووڵاتیی دیکە بە ناوەکانی "عەلی قادری" کوڕی "ڕەسووڵ"، "محەممەد قادری" کوڕی "عەزیز"، "حیسامەدین پیرانی" کوڕی "زاهیر،" "ئەمیر قادری" کوڕی "خدر" و "سەلام خڕی ئاغەڵان"، لەلایەن هێزە ئەمنییەتییەکانەوە دەسبەسەر کران.</s>	<s id="1:406">Following the arrest of Kurdish citizens in Piranshahr on Tuesday, May 5th, five citizens, Ali Ghaderi, son of Rasoul, Mohammad Qaderi, son of Aziz, Hesam Aldin Pirani, son of Zahir, Amir Ghaderi, son of Khadar and Salam Kheri Aghlan, were arrested by security forces.</s>
<s id="1:407">هەروەها ڕۆژی دووشەممە 15ی بانەمەڕ، هاووڵاتییەکی دیکە بە ناوی "واحید قادری" کوڕی "ڕەسووڵ"، لەلایەن هێزە ئەمنییەتییەکانەوە دەسبەسەر کرابوو.</s>	<s id="1:407">Also on Monday, May 4th, another citizen named "Vahed Qaderi", the son of Rasoul, was arrested by security forces.</s>
<s id="1:408">ئەو 6 هاووڵاتییە پاش دەسبەسەرکرانیان بۆ شوێنێکی نادیار ڕاگوێزراون و هیچ زانیارییەک لەمەڕ چارەنووسیان لەبەر دەستدا نییە.</s>	<s id="1:408">These six citizens were taken to an unknown location after their arrest, and their fates are unknown.</s>
<s id="1:409">هەتا ئێستا لە هۆکاری دەسبەسەرکردنی ئەو 6 هاووڵاتییە، هیچ زانیارییەک بە دەست نەهاتووە.</s>	<s id="1:409">So far, the exact reason for the arrest of these six citizens are unclear.</s>
<s id="1:410">لەو پەیوەندییەدا، ڕۆژی دووشەممە 15ی بانەمەڕ، دوو هاووڵاتیی کورد بە ناوەکانی "ئەحەد مەحموود حەسەن و "ئەبووبەکر مەحموود حەسەن" خەڵکی پیرانشار، لەلایەن هێزە ئەمنییەتییەکانەوە دەسبەسەر کران.</s>	<s id="1:410">In this regard, on Monday, May 4th, two Kurdish citizens named "Ahad Mahmoud Hassan" and "Abu Bakr Mahmoud Hassan" from Piranshahr were arrested by security forces.</s>
<s id="1:411">سەرلەبەیانیی ئەمڕۆ چوارشەممە 3ی بانەمەڕ، حوکمی لەسێدارەدانی "لوقمان ئەحمەدپوور" خەڵکی بانە، زیندانیی تاوانبار بە "کوشتنی بەئەنقەست"، لە زیندانی ناوەندیی سنە جێبەجێ کرا.</s>	<s id="1:411">This morning, Wednesday, April 22nd, the death sentence of a prisoner accused of "premeditated murder" named "Loghman Ahmadpour" from Baneh was carried out in Sanandaj Central Prison.</s>
<s id="1:412">ئەو زیندانییە ماوەی سێ ساڵ پێش بە تۆمەتی "کوشتنی بەئەنقەست" لە بانە دەسبەسەر کرا و دواتر بە قیساس مەحکووم کرابوو.</s>	<s id="1:412">This prisoner was arrested three years ago on charges of "premeditated murder" in Baneh and later sentenced to Qisas.</s>
<s id="1:413">"لوقمان ئەحمەدپوور"، تەمەنی 30 ساڵە، هەروەها خێزاندار و باوکی دوو منداڵە.</s>	<s id="1:413">Loghman Ahmadpour is 30 years old, married and has two children.</s>
<s id="1:414">لەو پەیوەندییەدا، ڕۆژی سێشەممە 2ی بانەمەڕ، "شایان سەعیدپوور"، زیندانیی مەحکووم بە ئێعدام، لە زیندانی سەقز لەسێدارە درا.</s>	<s id="1:414">In this regard, on Tuesday, April 21st, Shayan Saeedpour, a prisoner sentenced to death, was executed in Saqez Prison.</s>
<s id="1:415">ڕێکەوتی 28ی گەلاوێژی ساڵی 94، "شایان سەعیدپوور" لە کاتێکدا کە تەمەنی کەمتر لە 18 ساڵ بوو، لە ئەنجامی شەڕ و دەمەقاڵێ کەسێک بە ناوی "سلێمان ئازادی"ی کوشتبوو.</s>	<s id="1:415">On August 19th, 2015, Shayan Saeedpour, while under the age of 18, in a clash with a citizen killed a person named Suleman Azadi.</s>
<s id="1:416">دادسەرای نیزامیی ورمێ داخوازیی لێخۆشبوون و ئازادیی بێمەرجی "فاروق شاروێرانی" و "ئەمیر پەیغامی"، دوو زیندانیی سیاسیی کوردی خەڵکی شنۆی لە زیندانی کرمان ڕەت کردەوە.</s>	<s id="1:416">The Urmia Military Court rejected the request for parole and probation of Farooq Sharoviriani and Amir Peyghami, two Kurdish political prisoners from the city of Oshnovieh in Kerman Prison.</s>
<s id="1:417">به وتەی سەرچاوەیەکی ئاگادار، ئەو دوو زیندانییە کوردە پاش بڵاوبوونەوەی ڤایروسی کۆرۆنا چەند ڕۆژ پێش هاتبوونە مورەخەسی و بۆ داخوازیی لێخۆشبوون و ئازادیی بێمەرج سەردانی دادسەرای نیزامیی شاری ورمێیان کردبوو.</s>	<s id="1:417">According to an informed source, these two Kurdish political prisoners went on leave a few days ago after the outbreak of the corona virus and applied to the Urmia Military Court for amnesty and parole.</s>
<s id="1:418">ئەو سەرچاوەیە دەڵێت: "سەید ئیبراهیم حوسێنی دادوەری دۆسیەی ئەو دوو زیندانییە سیاسییە و شارام پەناهیان دادوەری جێبەجێکاری حوکمی دادسەرای نیزامیی ورمێ، لەگەڵ داخوازیی ئەو دوو زیندانییە سیاسییە کوردە دژایەتییان کردووە و بەوانی ڕاگەیاندووە کە لێخۆشبوون و ئازادیی بێمەرج نایانگرێتەوە."</s>	<s id="1:418">The informed source added: Seyyed Ebrahim Hosseini, the judge in the case of these two political prisoners, and Shahram Panahian, the judge in charge of enforcing the verdicts of the Urmia Military Court, opposed the request of these two political prisoners and announced that they would not be paroled.</s>
<s id="1:419">ئەو سەرچاوە ئاگادارە هەروەها ئەوەشی خستەڕوو: "سەید ئیبراهیم حوسێنی بەو دوو زیندانییە سیاسییە ڕاگەیاندووە کە گرینگ نییە کە دەزگای دادوەری و ڕێبەری حکوومەتی ئێران چ بڕیارگەلێک لە پێش دەگرن، ئێمە لێرە بڕیار دەدەین و لەگەڵ لێخۆشبوون و ئازادیی بێمەرجی ئێوە ناڕازین".</s>	<s id="1:419">The informed source stated: Seyyed Ebrahim Hosseini has announced to these two political prisoners that it does not matter what decisions the judiciary and the leader of the Iranian government make, we are ordering here and we are against your request for probation and parole.</s>
<s id="1:420">ڕۆژی یەکشەممە، 7ی ڕەزبەری ساڵی 98، ئەو دوو زیندانییە سیاسییە لە هەمبەر هەڵسوکەوتی نەشیاوی بەرپرسی حیفازەتی زیندانی کرمان و گوشار خستنە سەر ئەو دوو زیندانییە کوردە، دەستیان دابووە مانگرتن.</s>	<s id="1:420">On Sunday, September 29th, 2019, these two political prisoners went on strike to protest the inappropriate behavior of the head of the Kerman Prison's security department and to put pressure on them.</s>
<s id="1:421">ئەو دوو زیندانییە کوردە، ڕۆژی سێشەممە 14ی سەرماوەزی 96، لەلایەن دادگای نیزامیی شاری ورمێ، بە کۆ 8 ساڵ زیندان و دوورخرانەوە بۆ زیندانی کرمانیان بۆ بڕاوەتەوە.</s>	<s id="1:421">These two Kurdish political prisoners were sentenced to a total of eight years in prison and deportation to Kerman Prison by the Urmia Military Court on Tuesday, December 5th, 2017.</s>
<s id="1:422">بەپێی ئەو حوکمە کە ڕۆژی 25ی سەرماوەزی ساڵی 96، بە پارێزەرەکانی ئەو دوو هاووڵاتییە کوردە ڕاگەیەندراوە، "ئەمیر پەیغامی" بە 4 ساڵ و "فاروق شاروێرانی"ش بە 4 ساڵ زیندانیی تەعزیری مەحکووم کراون.</s>	<s id="1:422">Amir Peygami was sentenced to four years in discretionary imprisonment and Farooq Sharoviriani to four years in discretionary imprisonment, according to the verdict, which was announced on Saturday, December 16th, 2017 to the lawyers of these two Kurdish citizens.</s>
<s id="1:423">دادگای نیزامیی ورمێ، ئەو دوو هاووڵاتییە کوردەی بە تۆمەتی "هاوکاری لەگەڵ یەکێک لە حیزبە کوردییەکانی ئۆپۆزسیۆنی حکوومەتی ئێران" تاوانبار کردبوو.</s>	<s id="1:423">A military court in Urmia has accused these two Kurdish citizens to "collaborating with Kurdish opposition parties of the Iran.</s>
<s id="1:424">ڕۆژی دووشەممە 2ی ڕێبەندانی ساڵی 96، "فاروق شاروێرانی"، خەڵکی شنۆ لە زیندانی ورمێ بۆ زیندانی کرمان دوورخرایەوە و هەروەها ئەمیر پەیغامی ڕۆژی دووشەممە 25ی پووشپەری 98، بۆ زیندانی کرمان دوورخرایەوە.</s>	<s id="1:424">On Monday, January 22nd, 2018, Farooq Sharoviriani was deported from Urmia Prison to Kerman Prison, and Amir Peyghami was deported to Kerman Prison on Monday, July 16th, 2019.</s>
<s id="1:425">ڕۆژی سێشەممە، 6ی ڕەشەمە، هێزە ئیتلاعاتییەکان لە ورمێ لاوێکی کوردیان بە ناوی "سیروان محەممەدی" دەسبەسەر کرد و بۆ شوێنێکی نادیاریان ڕاگواست.</s>	<s id="1:425">On Tuesday, February 25th, intelligence forces arrested a Kurdish young man, Sirvan Mohammadi, from Urmia, and transferred him to an unknown location.</s>
<s id="1:426">دەسبەسەرکردنی ئەو لاوە کوردە بەبێ بەڵگەی یاسایی بووە و هەتا ئێستا هیچ زانیارییەک لەمەڕ چارەنووسی ناوبراو لەبەر دەستدا نییە.</s>	<s id="1:426">The arrest of this young Kurdish man was carried out without legal authorization, and his exact fate is not known.</s>
<s id="1:427">بە وتەی سەرچاوەیەکی ئاگادار، ئەو لاوە کوردە بە تۆمەتی "ئەندامبوون لە یەکێک لە حیزبە کوردییەکانی دژبەری حکوومەتی ئێران" دەسبەسەر کراوە.</s>	<s id="1:427">According to an informed source, this young Kurd was arrested on charges of "membership in one of the Kurdish opposition parties of the Iranian government."</s>
<s id="1:428">هەتا ئێستا بەدواداچوونی بنەماڵەی ئەو لاوە کوردە بۆ ئاگاداربوون لە چارەنووسی کوڕەکەیان بێئاکام ماوەتەوە.</s>	<s id="1:428">So far, the young Kurdish family's pursuit of his fate has been useless.</s>
<s id="1:429">چەند ڕۆژ پێش، لاوێکی کورد بە ناوی "پوویا پەروانە" کوڕی "عەبدوڵڵا"، تەمەن 18 ساڵ، لە نزیک سنووری شاری شنۆ، لەلایەن هێزەکانی سپای پاسدارانەوە دەسبەسەر کرا.</s>	<s id="1:429">A few days ago, a Kurdish young man named "Pouya Parvaneh", a 18-year-old, son of Abdullah, was detained by the Revolutionary Guards near the border of Oshnavieh.</s>
<s id="1:430">ئەو لاوە کوردە بۆ لێپرسینەوە بۆ یەکێک لە گرتنگەکانی ئەمنییەتی لە شاری ورمێ ڕاگوێزراوە.</s>	<s id="1:430">This Kurdish young man has been taken to a security detention center in Urmia for questioning.</s>
<s id="1:431">هەتا کاتی بڵاوبوونەوەی ئەم هەواڵە، لە هۆکاری دەسبەسەرکردنی ئەو لاوە تەمەن 18 ساڵەیە هیچ زانیارییەک لەبەر دەستدا نییە.</s>	<s id="1:431">No information is available on the reasons for arresting ofthe 18-year-old man until now.</s>
<s id="1:432">ڕۆژی پێنجشەممە، 5ی بەفرانبار، "عادڵ بەهرامی"، پەناخوازی سیاسیی کوردی خەڵکی کامیاران لەگەڵ 32 پەناخوازی دیکەی کورد لە وڵاتی تورکیەوە دیپۆرتی ئێران کرانەوە.</s>	<s id="1:432">Adil Bahrami, a Kurdish political refugee from Kamyaran, along with 32 other asylum seekers were deported from Turkey to Iran on Thursday December 26th.</s>
<s id="1:433">"چیا سۆهرابی" یەکێک لە هاوڕێیانی "عادڵ بەهرامی"، لە وتووژێکدا لەگەڵ ئاژانسی کوردپا ڕایگەیاند: "عادل بەهرامی 28ی ئاگوستی 2018ی زایینی خۆی بە کۆمیساریای باڵای پەناخوازانی ڕێکخراوی نەتەوەیەکگرتووەکان لە ئانکارا ناساند و کۆمیساریای باڵای پەناخوازان، شاری ئاماسیای وەکوو شوێنی نیشتەجێبوونی ئەو پەناخوازە سیاسییە دەستنیشان کرد".</s>	<s id="1:433">Chia Sohrabi, a friend of Adel Bahrami, said in an interview with the Kurdpa Agency: on August 28th, Adel Bahrami introduced himself to the United Nations High Commissioner for Refugees in Ankara and the UNHCR settle him in the city of Amassiar as a refugee.</s>
<s id="1:434">14ی دێسامبری ساڵی 2018ی زایینی، عادڵ بەهرامی لە کاتی چوونە دەرەوەی بە ڕێگای نایاسایی لە تورکیە، لە فڕۆکەخانەی ئانتالیا لەلایەن پۆلیسی تورکیەوە دەسبەسەر و ڕێکەوتی 24ی ژانویەی 2019، بۆ زیندانی ئانتالیا ڕاگوێزرا.</s>	<s id="1:434">On December 14th, Adel Bahrami was detained by Turkish police at the Antalya airport when he left Turkey illegally and was transferred to Antalya prison on January 24th.</s>
<s id="1:435">ناوبراو هەروەها وتی: "دادگاییکردنی ئەو پەناخوازە کوردە بە بەشداریی سێ پارێزەر لە سێ قۆناغدا لە دادگای تورکیە بەڕێوە چووە و دادگای ئەو وڵاتە حوکمی دیپۆرتکردنەوەی عادڵی دەر کرد".</s>	<s id="1:435">According to him, the trial of the Kurdish political asylum seeker was held in Turkish court by three lawyers in three stages and the court issued his deportation order.</s>
<s id="1:436">ئەو پەناخوازە کوردە ڕایگەیاند: "پاش بڕینەوەی حوکمی دادگا، عادڵ بەهرامی بۆ ماوەی یەک ساڵ لە گێری گۆندەرمە، ناوەندی ئانتالیا ڕاگیرا و پاش گواستنەوەی بۆ کەمپی ئاگری، ڕۆژی پێنجشەممە، 26ی دێسامبر، لە سنووری بازرگانەوە دیپۆرت کرایەوە".</s>	<s id="1:436">This Kurdish asylum seeker stated: After the court ruling, Adel Bahrami was held in Gary Gandarmah in central Antalya for a year and transferred to Agri Camp and from Bazargan border deported to Iran on Thursday, December 26th.</s>
<s id="1:437">"چیا سۆهرابی" ئەوەشی خستەڕوو: "پاش دیپۆرتکردنەوەی عادڵ بەهرامی بۆ ئێران، کۆمیساریای باڵای پەناخوازان، چیا سۆهرابیی ئاگادار کردبووەوە کە عادڵ دیپۆرتی ئێران دەکرێتەوە".</s>	<s id="1:437">Chia Sohrabi added: Prior to Adel Bahrami's deportation to Iran, he informed the UNHCR for the deportation of this political asylum seeker.</s>
<s id="1:438">"سۆهرابی" لە کۆتاییدا ئەوەشی خستەڕوو: "بەڵگەی چالاکیی ڕۆژنامەوانی و سیاسیی ئەو چالاکە کوردە لە فایلێکی تایبەتدا، ڕادەستی پۆلیسی تورکیە کراوە، بەڵام هەتا ئێستا هۆکاری دیپۆرتکردنەوەی عادڵ ناڕوونە".</s>	<s id="1:438">Sohrabi said at the end: "I handed over this Kurdish activist's documents to the Turkish police in a special file, but the reason for his deportation is unknown."</s>
<s id="1:439">"چیا سۆهرابی" خەڵکی دیواندەرەیە کە دوو ساڵ پێش وەکوو پەناخوازی سیاسی خۆی بە کۆمیساریای باڵای پەناخوازانی نەتەوەیەکگرتووەکان لە ئانکارا ناساند و چاوەڕوانی وەرگرتنی پەناخوازییەکەیەتی.</s>	<s id="1:439">Chia Sohrabi, from Divandarreh, has filed for political asylum with the United Nations High Commissioner for Refugees in Ankara two years ago and is awaiting an asylum application.</s>
<s id="1:440">ڕۆژی دووشەممە 5ی ڕەشەمە، لاوێکی کورد بە ناوی "ڕزگار ئەمینی" خەڵکی ورمێ، لەلایەن هێزە ئیتلاعاتییەکانەوە دەسبەسەر کرا.</s>	<s id="1:440">On Monday, February 24th, a Kurdish youth named "Rezgar Amini" from Urmia was arrested by intelligence forces.</s>
<s id="1:441">دەسبەسەرکردنی ئەو لاوە کوردە بەبێ بەڵگەی یاسایی بووە و ناوبراو بۆ لێپرسینەوە ڕەوانەی گرتنگەی ئیدارەی ئیتلاعاتی ورمێ کرابوو.</s>	<s id="1:441">The detainee was taken without legal authorization and transferred to the Urmia Intelligence Bureau for questioning.</s>
<s id="1:442">هەروەها، "ڕزگار ئەمینی"، ساڵی 96یش دەسبەسەر کرا و پاش تەواوبوونەوەی قۆناغی لێپرسینەوەکەی بە شێوەی کاتی ئازاد کرابوو.</s>	<s id="1:442">Rezgar Amini was also detained in 2017 and he was temporarily released after interrogations.</s>
<s id="1:443">لە لایەکی دیکەوە، لە هەمان ڕۆژ، لاوێکی دیکەی کورد بە ناوی "محەممەد فەقیزادە"، خەڵکی پیرانشار، لەلایەن هێزە ئیتلاعاتییەکانەوە دەسبەسەر کرا و لە چارەنووسی ئەو هاووڵاتییە کوردە هیچ زانیارییەک لەبەر دەستدا نییە.</s>	<s id="1:443">Also on the same day, a Kurdish young man named Mohammad Faghizadeh from Piranshahr, was arrested by intelligence forces and his exact fate is unknown.</s>
<s id="1:444">هەتا ئێستا بەدواداچوونی بنەماڵەی ئەو هاووڵاتییە کوردە بۆ ئاگاداربوون لە چارەنووسی کوڕەکەیان بێئاکام ماوەتەوە.</s>	<s id="1:444">So far, the follow-up to the family of this citizen to find out about his fate has not yielded any results.</s>
<s id="1:445">ئەو دوو لاوە کوردە بە تۆمەتی "هاوکاری لەگەڵ یەکێک لە حیزبە کوردییەکانی دژبەری حکوومەتی ئێران" لەلایەن هێزە ئیتلاعاتییەکانەوە دەسبەسەر کرابوون.</s>	<s id="1:445">These two Kurdish youths have been arrested by intelligence forces on charges of "collaborating with one of the Kurdish opposition parties of the Iranian government".</s>
<s id="1:446">لقی چواری دادگای پێداچوونەوەی سنە بە سەرۆکایەتیی "مستەفا تەیاری"، حوکمی زیندانیی "کامران ساختمانگەر"، چالاکی کرێکاریی کورد کە بە 6 ساڵ زیندانیی تەعزیری لەگەڵ توندترین سزا مەحکووم کردبوو، پشتڕاست کردەوە.</s>	<s id="1:446">The Fourth Branch of the Sanandaj Court of Appeals, presided over by Judge Mostafa Tayari, upheld the sentence of Kamran Sakhtemangar, a Kurdish labor activist who had been sentenced to six years in prison.</s>
<s id="1:447">دادگای پێداچوونەوەی سنە بە ڕەتکردنەوەی پێداچوونەوەی دۆسیەی ئەو چالاکە کرێکارییە، بە پشتبەستن بە بەندی ئەلفی مادەی 455ی یاسای ئایینی دادڕەسیی کەیفەری، بەرگەی فەرمیی پێداچوونەوەی پشتڕاست کردەوە و ئەوە بڕیاری کۆتاییە.</s>	<s id="1:447">The Sanandaj Court of Appeals rejected the appeal of this labor activist, citing paragraph A of Article 455 of the Code of Criminal Procedure, which upheld the appeal and ruled.</s>
<s id="1:448">28ی خەزەڵوەری ساڵی 98، "کامران ساختمانگەر"، چالاکی کرێکاریی خەڵکی سنە، لەلایەن لقی یەکی دادگای ئینقلاب بە سەرۆکایەتیی دادوەر "حوسێن سەعیدی"، بە تۆمەتی "ئەندامبوون لە یەکێک لە حیزبە کوردییەکانی ئۆپۆزسیۆنی حکوومەتی ئێران"، بە پێنج ساڵ زیندان و هەروەها بە تۆمەتی "پڕوپاگەندە دژی نیزام" بە ساڵێک زیندان مەحکووم کرابوو.</s>	<s id="1:448">On November 19th, 2019, Kamran Sakhtemangar, a labor activist from Sanandaj, was sentenced to five years in prisonon charges of membership in one of the Kurdish opposition by the First Branch of the Revolutionary Court, presided over by Judge Hossein Saeedi, he was also sentenced to one year in prison, including previous days of detention and severe punishment on charges of propaganda against the regime.</s>
<s id="1:449">ئەو چالاکە کرێکارییە، ڕۆژی پێنجشەممە 14ی خەرمانانی 98، لە پەیوەندی لەگەڵ چالاکییەکانی لەمەڕ پشتیوانی لە مافی کرێکاران، لە باخی کەسیی سەید "عەلی حوسێنی"، چالاکێکی دیکەی کرێکاری، لە یەکێک لە گوندەکانی دەوروبەری سەقز دەسبەسەر و بۆ گرتنگەی ئیدارەی ئیتلاعاتی سنە ڕاگوێزرابوو.</s>	<s id="1:449">This labor activist from Sanandaj was arrested on Thursday, September 5th, 2019, in connection with his activities in support of workers' rights in the private garden of Seyed Ali Hosseini, another labor activist in a village around Saqez, and he transferred to Sanandaj Ettelaat Detention Center.</s>
<s id="1:450">ئەو چالاکە کرێکارییە، ڕۆژی چوارشەممە 6ی سەرماوەز 98، بە دانانی بارمتەی 200 ملیۆن تمەنی لە گرتووخانەی سنە ئازاد کراوە.</s>	<s id="1:450">This labor activist was released from Sanandaj Central Prison on Wednesday, November 27th, with a bail of 200 million Tomans.</s>
<s id="1:451">کاتژمێر 1ی شەوی دووشەممە 22ی بانەمەڕ، هێزە ئیتلاعاتییەکان لە شارۆچکه "پەسوێ"ی شاری پیرانشار، مێرمنداڵێکی تەمەن 17 ساڵەیان بە ناوی "سەمیع شەریفیان" کوڕی "حەسەن" دەسبەسەر کرد و بۆ شوێنێکی نادیاریان ڕاگواست.</s>	<s id="1:451">On Monday evening, May 11, security forces arrested a Kurdish teenager named Sami Sharifian, 17, son of Hasan from the city of Pashweh in Piranshahr, and taken him to an unknown location.</s>
<s id="1:452">بە وتەی سەرچاوەیەکی ئاگادار، هێزە ئیتلاعاتییەکان نیوە شەو هێرشیان کردووەتە سەر ماڵی باوکی ئەو مێرمنداڵە و دەسبەسەریان کردووە.</s>	<s id="1:452">According to an informed source, security forces raided the teenager's home and arrested him without any legal permission.</s>
<s id="1:453">لقی یەکی دادگای ئینقلابی سنە، بە سەرۆکایەتیی دادوەر "سەعیدی"، حوکمی سێ ساڵ زیندانیی تەعزیریی بەسەر "پەریسا سەیفی"، چالاکی مەدەنیی خەڵکی کامیاراندا سەپاند.</s>	<s id="1:453">The first branch of the Sanandaj Revolutionary Court, headed by Judge Saeedi, has issued a three-year prison sentence for "Parisa Seifi", a Kamyaran cultural activist.</s>
<s id="1:454">لقی 1ی دادگای ئینقلابی سنە، ئەو چالاکە فەرهەنگییەی بە "پڕوپاگەندە دژی نیزام و ئەندامبوون لە یەکێک لە حیزبە کوردییەکانی ئۆپۆزسیۆنی حکوومەتی ئێران" تۆمەتبار کرد.</s>	<s id="1:454">First Branch of the Sanandaj Revolutionary Court has charged thisl cultural activist with "propaganda against the system and membership in one of the Kurdish opposition parties of the Iranian government."</s>
<s id="1:455">ئەو چالاکە فەرهەنگییە کوردە، بەو حوکمە کە لەلایەن دادگاوە بەسەریدا سەپاوە، ناڕەزایەتیی دەربڕیوە و دۆسیەی بۆ پێداچوونەوە ڕەوانەی دادگای پێداچوونەوەی سنە کراوە.</s>	<s id="1:455">This Kurdish cultural activist appealed against this verdict and her file has been referred to the Sanandaj Court of Appeal for reconsideration.</s>
<s id="1:456">"پەریسا سەیفی"، خوێندکاری بواری "هونەر و گرافیک"، ڕۆژی سێشەممە، 21ی خەزەڵوەر، لە سنە و لەلایەن هێزە ئیتلاعاتییەکانەوە دەسبەسەر کرابوو.</s>	<s id="1:456">Parisa Seifi, a student of art and graphic, was arrested by intelligence forces at her residence in Sanandajon Tuesday, November 12, 2019.</s>
<s id="1:457">ناوبراو ڕێکەوتی 4ی ڕەشەمەی 98، بە دانانی بارمتەی قورس بە شێوەی کاتی ئازاد کرابوو.</s>	<s id="1:457">This cultural activist was released on February 23rd, 2020, on a heavy bail.</s>
<s id="1:458">ڕۆژی دووشەممە 26ی ڕەشەمە، هاووڵاتییەکی کورد بە ناوی "کەیوان ئەعزەمی"، تەمەن 37 ساڵ و خەڵکی گوندی "کلێنە"ی شاری سەرپێڵ زەهاو، لە ئەنجامی تەقینەوەی گوللە خومپارەیەکی بەجێماو لە شەڕی 8 ساڵەی عێراق و ئێران، بەهۆی قورسیی برینەکانیەوە گیانی لەدەست دا.</s>	<s id="1:458">On Monday, March 16th, a Kurdish citizen, Keyvan Azami, 37, from the village of Kohlineh, died in Sarpol Zahab due to the severity of the mortar blast caused by the eight-year war between Iran and Iraq.</s>
<s id="1:459">ئەو ڕووداوە، ڕۆژی یەکشەممە 25ی ڕەشەمە ڕوویداوە و ئەو هاووڵاتییە بەهۆی قورسیی برینەکانیەوە لە نەخۆشخانە گیانی لەدەست داوە.</s>	<s id="1:459">In this incident, which took place on Sunday, March 15th, this Kurdish citizen was seriously injured and due to severe injury died in hospital.</s>
<s id="1:460">دوای زیاتر لە 3 دەیە لە کۆتاییهاتنی شەڕی ئێران و عێراق، ناوچە تەندراوەکان بە مین و کەرەستە تەقەمەنییەکان لە کوردستان، بە بەردەوامی گیانی هاووڵاتییان دەستێنێت و هەتا ئێستا حکوومەتی ئێران، پارەیەکی بۆ خاوێنکردنەوەی ناوچە ئالوودەبووەکان بە مین و کەرەستە تەقەمەنییەکان لە کوردستان تەرخان نەکردووە.</s>	<s id="1:460">More than three decades after the end of the eight-year war between Iran and Iraq, mine-affected areas and war munitions continue to be victimized in Kurdistan, and the Iranian government has so far failed to provide funding to clear mine-affected areas and war munitions in Kurdistan.</s>
<s id="1:461">ئێوارەی ڕۆژی هەینی 19ی بانەمەڕ، ژمارەیەک لە کۆڵبەران لە سنووری "بلە سووری خوارێ" سەر بە شاری خۆی، لەلایەن هێزە نیزامییەکانی حکوومەتەوە تەقەیان لێ کراوە.</s>	<s id="1:461">On the evening of Friday, May 8th, a group of Kurdish Kolbars were shot by Iranian government forces on the border of "Bolsur Sofla" in Khoy.</s>
<s id="1:462">لە ئەنجامی تەقەی ئەو هێزانە، کۆڵبەرێکی کورد بە ناوی "لوقمان چوارگوشە" گیانی لەدەست دا و دوو کۆڵبەری دیکە بە ناوەکانی "مەنسوور چوارگوشە و مەیسەم محەممەدی"، بەتوندی بریندار بوون.</s>	<s id="1:462">One Kolbar "Loghman Chahargoosheh" was killed and two others named "Mansour Chahargoosheh and Meysam Mohammadi" were severely injured.</s>
<s id="1:463">ڕۆژی سێشەممە 16ی بانەمەڕ، هێزەکانی سپای پاسداران لەگەڵ گرووپێکی چەکداری نەناسراو، لە "چلچەمە"ی دیواندەرە دەرگیر بوون.</s>	<s id="1:463">On Tuesday, May 5th, Revolutionary Guards clashed with an armed group in Chehel Cheshmeh, Divandarreh.</s>
<s id="1:464">پەیوەندییە گشتییەکانی قەرارگای حەمزەی سپای پاسداران لەمبارەوە ڕایگەیاندووە، "شەکیبا سەلیمی"، لە فەرماندەکانی سپای پاسداران، لەگەڵ "جەعفەر نیزامپوور و محەممەد شوکری"، دوو ئەندامی تری سپا، لەم تێکەڵچوونەدا کوژراون.</s>	<s id="1:464">The IRGC's Hamzeh base's public relations office said that Shakiba Salimi, one of the IRGC's commanders, along with Jafar Nezampour and Mohammad Shokri, two other IRGC members, were killed in the clashes.</s>
<s id="1:465">قەرارگای حەمزەی سپا ڕایگەیاندووە کە ئەم تێکەڵچوونە لەگەڵ حیزبێکی کوردیی دژبەری حکوومەر بووە، بەڵام تا ئێستا هیچ لایەنێک بەرپرسیاریەتیی ئەم دەرگیرییەی وەئەستۆ نەگرتووە.</s>	<s id="1:465">Hamzeh Sepah's headquarters attributed the clash to the Kurdish opposition parties of the Iranian government, but so far no one has claimed responsibility for the clash.</s>
<s id="1:466">ڕۆژی یەکشەممە، 11ی ڕەشەمە، هێزە ئیتلاعاتییەکان بە هێرش کردنە سەر ماڵی هاووڵاتییەک بە ناوی "سەید مستەفا سەبری" و کوڕەکەی بە ناوی "سەید ئەحمەد سەبری" لە شاری "دێی پەسوێ" سەر بە پیرانشار، بەبێ بەڵگەی یاسایی ئەوانیان دەسبەسەر کردووە.</s>	<s id="1:466">On Sunday, March 1st, intelligence forces raided the home of Sayed Mustafa Sabri and his son, Sayed Ahmad Sabri, in the city of Pasveh, and arrested them without legal authorization.</s>
<s id="1:467">ئەو سەرچاوەیە هەروەها ئەوەشی خستەڕوو، سەید مستەفا سەبری، پاش چەند کاتژمێر ئازاد کراوە، بەڵام کوڕەکەی هەتا ئێستا لە گرتنگەی هێزە ئیتلاعاتییەکان ڕاگیراوە.</s>	<s id="1:467">Sayed Mustafa Sabri was released after several hours of detention, but his son remains in the custody of intelligence forces, the source added.</s>
<s id="1:468">ئەو سەرچاوەی هەروەها وتی: "سەید ئەحمەد سەبری پاش دەسبەسەرکرانی بۆ شوێنێکی نادیار ڕاگوێزراوە و هیچ زانیارییەک لەمەڕ چارەنووسی لەبەر دەستدا نییە".</s>	<s id="1:468">Sayed Ahmad Sabri was taken to an unknown location after his arrest and his fate is not known, the source said.</s>
<s id="1:469">هەتا ئێستا هۆکاری دەسبەسەرکردنی ئەو دوو هاووڵاتییە کوردە ناڕوونە.</s>	<s id="1:469">No exact information has been released as to the arrests of the two Kurdish citizens.</s>
<s id="1:470">بە پشتبەستن بە ئاماری تۆمارکراو لە ناوەندی ئاماری "مین و زندگی"، 37 هاووڵاتی بەهۆی تەقینەوەی مین لە ئێران و کوردستان لە ماوەی یەک ساڵی ڕابردوودا (ساڵی 98) کوژراون و بریندار بوون.</s>	<s id="1:470">According to the statistics recorded in "Mine and Life", 37 citizens were killed and injured in a landmine explosion in Iran and Kurdistan during 1398.</s>
<s id="1:471">لە کۆی ئەم ئامارە، 9 هاووڵاتی بەهۆی تەقینەوەی مین گیانیان لەدەست داوە کە خەڵکی پارێزگاکانی "خووزستان، گوڵستان، ورمێ، سنە و کرماشان"ن.</s>	<s id="1:471">Out of this total, 9 citizens lost their lives in a landmine accident in Khuzestan, Golestan, Urmia, Sanandaj and Kermanshah provinces.</s>
<s id="1:472">لەم ئامارە، 6 کەس کە تەمەنیان ژێر 18 ساڵ بووە بەهۆی تەقینەوەی مین بریندار بوون.</s>	<s id="1:472">In that statistic, 6 people were injured in a landmine explosion under the age of 18.</s>
<s id="1:473">بە پشتبەستن بەم ئامارە، زۆربەی برینداربووەکانی مین، لاق و دەستیان قرتاوە و کەمئەندام بوون.</s>	<s id="1:473">According to these statistics, most of the injured in the legs and arms have been mutilated.</s>
<s id="1:474">لە کۆی 42 حاڵەتی ڕووداوی تەقینەوەی مین و کەرەستە تەقەمەنییەکانی شەڕ لە ئێران و کوردستان، سێ حاڵەتیان بووەتە هۆی لەنێوچوونی مەڕ و ماڵات.</s>	<s id="1:474">Of the 42 landmine and munitions explosions in Iran and Kurdistan, 3 have resulted in the loss of livestock.</s>
<s id="1:475">"مین و زندگی" لە بواری زانیاری گەیاندن لە پەیوەندی لەگەڵ ئاگادارکردنەوەی مەترسییەکانی مین لە پارێزگا ئالوودە بە مینەکان چالاکی دەکات و هەوڵی بڵاوکردنەوەی ڕاپۆرت و هەواڵ سەبارەت بە ڕووداوت تەقینەوەی مین و کەرەستە تەقەمەنییەکانی مین دەدات.</s>	<s id="1:475">"Mine and Life" works to raise awareness about the dangers of landmines in mine-affected provinces and publishes reports and news about landmine explosions and ammunition.</s>
<s id="1:476">ئەمڕۆ دووشەممە 11ی خاکەلێوە، هاووڵاتییەکی کورد بە ناوی "ڕەحیم حەسەن مەحاڵی" تەمەن 50 ساڵ کوڕی کەریم و خەڵکی شاری پیرانشار، پاش دوو حەفتە ڕاگیرانی لە بەندی دابڕگە، بۆ تیپەڕاندنی ماوەی حوکمەکەی بۆ بەندی سێ زیندانی ورمێ ڕاگوێزرا.</s>	<s id="1:476">On Monday, March 30th, a Kurdish citizen named "Rahim Hassan Mahali", 50, son of Karim from Piranshahr, was transferred to ward three of Urmia Prison after serving two weeks in quarantine.</s>
<s id="1:477">ئەو هاووڵاتییە کوردە، ساڵی 97 لەلایەن هێزە ئیتلاعاتییەکانەوە دەستبەسەر و پاش 32 ڕۆژ لە گرتنگەی ئیدارەی ئیتلاعاتی ورمێ، بۆ زیندانی ناوەندی ئەو شارە ڕاگوێزرا و دواتر بە دانانی بارمتە بە شێوەی کاتی ئازاد کرابوو.</s>	<s id="1:477">This Kurdish citizen was detained by intelligence forces and after 32 days detention in Urmia Ettelaat Detention Center, they transferred him to the central prison of Urmia and then released on bail.</s>
<s id="1:478">سەرلەبەیانیی ئەمڕۆ دووشەممە 8ی بانەمەڕ، زیندانییەک بە ناوی "کەیوان ئەڵڵامورادی" خەڵکی گوندی "بڵواناوا"ی شاری دێولان، بە تاوانی "کوشتنی بەئەنقەست" لە زیندانی ناوەندیی سنە لەسێدارە درا.</s>	<s id="1:478">On the morning of Monday, April 27th, a prisoner accused of "murder" named Keyvanullah Moradi, 28, resident of the village of Belbanabad in Dehgolan, was executed in Sanandaj Central Prison.</s>
<s id="1:479">ئەو زیندانییە پێنج ساڵ پێش، لە کاتی شەڕ و دەمەقاڵێدا، هاووڵاتییەکی قوروەیی بە ناوی "عیماد خالدیان" کوشت.</s>	<s id="1:479">This prisoner committed the murder of a citizen from Qorveh named Emad Khaledian five years ago in a clash.</s>
<s id="1:480">ئەو زیندانییە پاش ماوەیەک لە زیندانی قوروە بۆ زیندانی سنە ڕاگوێزرابوو.</s>	<s id="1:480">This prisoner was transferred to Sanandaj Prison from Qorveh Prison some time ago.</s>
<s id="1:481">"کەیوان ئەڵڵامورادی" خێزاندار و خاوەنی منداڵێکە.</s>	<s id="1:481">Keyvanullah Moradi is married and has one child.</s>
<s id="1:482">ڕۆژی دووشەممە 18ی خاکەلێوە، کۆڵبەرێکی کورد بە ناوی "بورهان جنکانلو" تەمەن 28 ساڵ، خەڵکی شاری بازرگان سەر بە ماکۆ، لە بەرزاییەکانی سنووری ئەو شارە بە تەقەی هێزە نیزامییەکانی حکوومەتی ئێران گیانی لەدەست دا و دوو کۆڵبەری دیکە بریندار بوون.</s>	<s id="1:482">On Monday, April 6, a Kurdish kolbar named Borhan Jankanlu, 28, resident of Bazargan, Maku, was killed in a direct firings by government troops and two other Kolbars were wounded.</s>
<s id="1:483">هێزە نیزامییەکانی حکوومەت بەبێ ئاگادارکردنەوەی پێشوو و بە گومانی هەڵگرتنی شتومەکی قاچاغ تەقەیان لەو کۆڵبەرانە کردبوو.</s>	<s id="1:483">Iranian government forces have fired directly at them because government officials have thought they are carrying smuggle goods.</s>
<s id="1:484">کۆڵبەرانی بریندار بۆ چارەسەریی پزیشکی ڕەوانەی ناوەندی دەرمانیی ماکۆ کراون.</s>	<s id="1:484">The injured Kolbars were taken to Maku Medical Center for medical treatment.</s>
<s id="1:485">"بورهان جنکانلوو" خێزاندار و باوکی دوو منداڵە.</s>	<s id="1:485">Borhan Jankanlu is married and has two children.</s>
<s id="1:486">فێرگەی کوردی دەست بە وتنەوەی وانەکانی زمانی کوردی دەکات </s>	<s id="1:486">Learning Kurdish online with Fêrgeha Kurdî</s>
<s id="1:487">کچانی رۆژ لە دژی داعش </s>	<s id="1:487">Girls of the Sun against ISIS</s>
<s id="1:488">تیپی ئاوازی چیا گۆرانییەکى نوێی بە ناوی "لە چیاوە بەرەو دەریا" بڵاوکردەوە </s>	<s id="1:488">New song by guerrilla band Awazê Çiya: From mountains to seas</s>
<s id="1:489">راگەیاندراوى ڕێکخراوە مەدەنییەکانی مەریوان بە بۆنەى رۆژى جیهانیى زمانى دایکەوە </s>	<s id="1:489">Marivan's organizations on International Mother Language Day</s>
<s id="1:490">دەوڵەتى تورکیا کتێبی کوردیی لە پێشانگایى کتێبی وان دا قەدەغە کرد </s>	<s id="1:490">Kurdish publications banned in Van Book Fair</s>
<s id="1:491">لە ڕووسیا کۆرسی زمانی کوردی دەستیپێکرد </s>	<s id="1:491">Kurdish language course opened in Russia</s>
<s id="1:492">یەپەگە بەڕێزەوە یادی ٧ شەهیدی ساڵی ٢٠١٦ی کردەوە </s>	<s id="1:492">YPG pays tribute to 7 fighters who fell martyrs in Manbij in 2016</s>
<s id="1:493">دەوڵەتی تورک لە عەفرین ٥ هاوڵاتی مەدەنی ڕفاند </s>	<s id="1:493">Turkish-backed mercenaries kidnap 5 civilians in Afrin</s>
<s id="1:494">لە قامشلۆ رژێم هێرشی کرد، ئەندامێکی ئاسایش شەهید بوو </s>	<s id="1:494">Attack kills a member of security forces in Qamishlo</s>
<s id="1:495">داگیرکەران هێرشیان کردە سەر گوندی خربەتبەقری گرێ سپی </s>	<s id="1:495">Turkish invaders attacks village of Xirbitbeqir in Girê Spî</s>
<s id="1:496">HRE: ئەرکی سەرەکیمان ئازادکردنی عەفرینە </s>	<s id="1:496">HRE: Our main duty is the liberation of Afrin</s>
<s id="1:497">داگیرکەران لە عەفرین ٢ هاووڵاتیی تریان رفاند </s>	<s id="1:497">Two more civilians abducted in occupied Afrin</s>
<s id="1:498">داگیرکەران گوندەکانی عەین عیسا تۆپباران دەکەن </s>	<s id="1:498">Occupation forces attack villages in Ain Issa</s>
<s id="1:499">مەسەدە:لە دژی داگیرکەری پێویستە جەنگی رزگاری رابگەیێنرێت </s>	<s id="1:499">MSD calls for liberation war for Afrin and Turkish-occupied lands</s>
<s id="1:500">لە قامشلۆ نەورۆز پیرۆزکرا </s>	<s id="1:500">Newroz celebrated in Qamislo</s>
<s id="1:501">داگیرکەران لە عەفرین بەربوونەتە یەکتری و شەڕ لەگەڵ یەک دەکەن </s>	<s id="1:501">Mercenaries clash among themselves in Afrin</s>
<s id="1:502">داگیرکەران گوندەکانى شێراوا و شەرا بۆردومان دەکەن </s>	<s id="1:502">Turkish invaders attack villages of Shêrawa and Shera</s>
<s id="1:503">داگیرکەران گوندەکانی شەهبایان تۆپباران کرد </s>	<s id="1:503">Turkish invaders bomb villages of Shehba</s>
<s id="1:504">فڕۆکە بێفڕۆکەوانە هێرشبەرەکانى دەوڵەتى تورک لە ئاسایشی کۆبانێیان دا </s>	<s id="1:504">Turkish armed drone hits Kobanê public order forces</s>
<s id="1:505">هێزەکانی ڕزگاری عەفرین: ٨ داگیرکەر کوژران و ٢ ئۆتۆمبێڵ تێکشکێنران </s>	<s id="1:505">HRE: 8 invaders killed, 2 vehicles destroyed</s>
<s id="1:506">لە عەفرین و عەزاز ٢ چەتە کوژران </s>	<s id="1:506">HRE: Two mercenaries killed in Afrin and Azaz</s>
<s id="1:507">دەوڵەتی داگیرکەری تورک لە گرێ سپی هاوڵاتیەکی مەدەنی شەهید کرد </s>	<s id="1:507">Civilian from Gire Spi tortured to death by Turkish-backed gangs</s>
<s id="1:508">لە ئیدلب دەوڵەتی تورک و شاندی هێزەکانی تەحریر ئەلشام کۆبوونەوە </s>	<s id="1:508">Turkey and HTŞ meet after tension in Idlib</s>
<s id="1:509">داگیرکەران گوندەکانى عەفرین و تلتەمر بۆردومان دەکەن </s>	<s id="1:509">Turkish state bombing villages of Afrin and Til Temir</s>
<s id="1:510">ئیسرائیل بە موشەک لە سوریای دا </s>	<s id="1:510">Israel carries out new air strikes against Syria</s>
<s id="1:511">لە شەهبا مەترسی ڤایرۆسی کۆرۆنا و هەڕەشەکانی ئەنقەرە </s>	<s id="1:511">Shehba refugees face double threat: coronavirus and Ankara</s>
<s id="1:512">٣ کەسی دیکە کە لە کەمپی نەورۆز سووتابوون، گیانیان لەدەستداوە </s>	<s id="1:512">Three people injured by fire in Newroz camp die in hospital</s>
<s id="1:513">رژێمی تورک ١٠ هەزار و ٣٠٠ سەربازی لە ئیدلب و حەڵەب جێگیرکردووە </s>	<s id="1:513">Turkey deploys 10,300 soldiers in Aleppo and Idlib since February</s>
<s id="1:514">لە باکوور و ڕۆژهەڵاتی سوریا قەدەغەی هاتوچۆ ڕاگەیەنرا </s>	<s id="1:514">Curfew begins in North and East Syria</s>
<s id="1:515">نەتەوە یەکگرتووەکان بەهۆی بڕینی ئاوی رۆژئاواى کوردستانەوە هۆشداریی بە تورکیا دا </s>	<s id="1:515">UNICEF worried for interruption of water supply in NE Syria</s>
<s id="1:516">چەتەکانی دەوڵەتی تورک لە عەفرین و سەرێکانی شەڕی یەکتری دەکەن </s>	<s id="1:516">Turkish-backed mercenaries clash in Afrin and Serêkaniyê</s>
<s id="1:517">دەوڵەتی تورک تل رەفعەتی تۆپباران کرد </s>	<s id="1:517">Turkish army shells a village in Til Rifat</s>
<s id="1:518">یەپەگە: پەیوەندیمان بە تەقینەکەی عەفرینەوە نییە </s>	<s id="1:518">YPG: We have no connection with the Afrin attack</s>
<s id="1:519">دەوڵەتی تورک لە ئیدلب بنکەی نوێی سەربازی دروست دەکات </s>	<s id="1:519">Turkey sets up new military points in Idlib countryside</s>
<s id="1:520">سوپای داگیرکەری تورک لە بلبل دەستی بە دروستکردنی دیوار کرد </s>	<s id="1:520">Turkey has a fence erected around Bilbile district of Afrin</s>
<s id="1:521">مانگی سووری کورد لە حەسەکە نەخۆشخانەی ڤایرۆسی کۆرۆنای کردەوە </s>	<s id="1:521">Heyva Sor a Kurd sets up Covid-19 hospital in Hesekê</s>
<s id="1:522">لە ئەرزینجان بە گوڕی ٤.٠ پلەی ریختەر بومەلەرزەیەک روودا </s>	<s id="1:522">4.0 magnitude earthquake in Erzincan</s>
<s id="1:523">گەنجانی کورد لە مارسیلیا لەدژی داگیرکەری چالاکیان ئەنجامدا </s>	<s id="1:523">Young Kurdish activists stage demonstrations in Marseille</s>
<s id="1:524">خانەوادە و پارێزەران بۆ ئەوەی بچنە ئیمڕالی سەردانیان کرد </s>	<s id="1:524">Families and lawyers apply to visit Imralı</s>
<s id="1:525">نەتەوە یەکگرتووەکان بانگەوازی 'ئازادکردنی زیندانیان'ی کرد </s>	<s id="1:525">UN calls on governments to reduce the number of prisoners</s>
<s id="1:526">پارتەکانی دانیمارک هێرشی سەر مەخمووریان شەرمەزار کرد </s>	<s id="1:526">Danish parties condemn attack on Maxmur Camp</s>
<s id="1:527">لە تورکیا لە ماوەی ٢٤ کاتژمێردا ٥٩ کەس گیانیان لەدەستدا </s>	<s id="1:527">Officials say 59 people died of coronavirus in the past 24 hours</s>
<s id="1:528">لە بەرن و شتوتگارت چالاکی ئەنجامدران </s>	<s id="1:528">Activists in Bern and Stuttgart protest Turkey</s>
<s id="1:529">هەدەپە: بە هۆی کۆرۆناوە پێویستە زیندانیانی نەخۆش و بەتەمەنەکان ئازاد بکرێن </s>	<s id="1:529">HDP calls for the release of prisoners over coronavirus threat</s>
<s id="1:530">گەنجان لە پاریس بۆ ئۆجالان چالاکیان ئەنجامدا </s>	<s id="1:530">Young people march for Öcalan in Paris</s>
<s id="1:531">یەکیتیی هێزی دیموکراتیک هێرشەکەی سەر کەمپی مەخموری ئیدانەی کرد </s>	<s id="1:531">Democratic Forces Union condemns attack against Maxmur</s>
<s id="1:532">پلاتفۆڕمی ژینگه‌پارێزی: دارستانه‌كان به‌ بیانووی ئه‌منی ده‌سووتێنرێن </s>	<s id="1:532">Ecology Platform: Forests are burned for "security reasons"</s>
<s id="1:533">فڕۆکە جەنگیەکانی دەوڵەتی تورک هەرێمی برادۆسیان بوردومان کرد </s>	<s id="1:533">Turkish warplanes bomb the region of Bradost</s>
<s id="1:534">لە باشوری کوردستان قەدەغەی هاتووچۆ ١ی ئایار درێژ کرایەوە </s>	<s id="1:534">Curfew in Southern Kurdistan extended until May</s>
<s id="1:535">رێپێوانی درێژمەودای گەنجان بەرەو زینی وەرتێ دەستیپێکرد </s>	<s id="1:535">Long March to Zînî Wertê faces obstacles</s>
<s id="1:536">فڕۆکە بێفڕۆکەوانەکانی دەوڵەتی داگیرکەری تورک کەمپی مەخموریان بوردومان کرد – نوێ کرایەوە - </s>	<s id="1:536">Turkish armed drones bomb Maxmur - UPDATED</s>
<s id="1:537">دەوڵەتى تورک هێزە سەربازییەکانى لە باشووری کوردستان زیاتر دەکات </s>	<s id="1:537">Turkish state makes new military shipments to South Kurdistan</s>
<s id="1:538">فڕۆکە نەناسراوەکان شاخی قەڕەچوخیان بۆردومان کرد </s>	<s id="1:538">Warplanes bomb Mount Qereçox in Maxmur</s>
<s id="1:539">هەپەگە: بە ڕێزەوە یادی فەرماندەی گەورە تێکۆشەر گەڤەر بەرز رادەگرین </s>	<s id="1:539">HPG pays tribute to commander Tekoşer Gever</s>
<s id="1:540">فڕۆکەی کەشف بەسەر ئاسمانی مەخموورەوە دەفڕن </s>	<s id="1:540">Reconnaissance flights over Maxmur continue</s>
<s id="1:541">کەجەکە: دەبێت رەمەزانی ئەمساڵ ببێتە هۆی ئازادی گەلی کورد </s>	<s id="1:541">KCK: This Ramadan should bring unity and freedom to Kurds</s>
<s id="1:542">کەجەکە: پشتگیری و ڕێکخستن بەهێز بکەین </s>	<s id="1:542">KCK calls for strengthened solidarity and organization</s>
<s id="1:543">هەپەگە: لە خواکورک ٣ سەربازی دوژمن کوژران </s>	<s id="1:543">HPG: Three Turkish soldiers killed in Xakurke</s>
<s id="1:544">٨ی ئازار لە گۆتەبۆرگ و ئۆەبروی پیرۆزکرا </s>	<s id="1:544">8 March celebrations in Gothenburg and Örebro</s>
<s id="1:545">داگیرکەران لە عەفرین هاوڵاتیەکی مەدەنیان رفاند </s>	<s id="1:545">Another civilian kidnapped in occupied Afrin</s>
<s id="1:546">بەڕێوەبەرایەتی خۆسەر ناڕەزایی بەرانبەر هێرشی سەر کۆبانی پیشاندا </s>	<s id="1:546">Autonomous administration condemns Turkish attack on Kobanê</s>
<s id="1:547">چەتەکانی رژێم هێرشیان کردە سەر خاڵێکی پشکنینی ئاسایشی قامشلۆ </s>	<s id="1:547">Attack on a checkpoint causes material damage in Qamishlo</s>
<s id="1:548">گوندێکی شەهبا بەگۆمانی ڤایرۆسی کۆرۆنا کەرەنتینەکرا </s>	<s id="1:548">Village in Shehba under quarantine over corona suspicion</s>
<s id="1:549">لە عەین عیسا مینێک تەقیەوە و منداڵیک گیانی لەدەستدا </s>	<s id="1:549">Child killed in mine explosion in Ain Issa</s>
<s id="1:550">هێزەکانی رژێم حەلەبیان کۆنترۆڵ کرد </s>	<s id="1:550">Aleppo under full control of the Syrian regime</s>
<s id="1:551">چەتەکانی تورکیا لە رێگای M5 دەکشێنەوە </s>	<s id="1:551">Turkish-backed militias set to withdraw from M5</s>
<s id="1:552">دەوڵەتی تورک لە گوندی ئاقیبە هاوڵاتییەکی ٦٥ ساڵانی کوشت </s>	<s id="1:552">Fierce attacks kill a 65-year-old in a village of Afrin</s>
<s id="1:553">ڕیگای ئێم٥ دوای ٧ ساڵ بە ڕووی خەڵکی مەدەنیدا کرایەوە </s>	<s id="1:553">Turkish-backed militias set to withdraw from M5</s>
<s id="1:554">لە سەرێکانی ئۆتۆمبێلێکى بۆمبڕێژکراو تەقییەوە </s>	<s id="1:554">Car bomb explodes in Serêkaniyê</s>
<s id="1:555">لە جەرابلوس شەڕ لە نێوان چەتەکاندا روویدا </s>	<s id="1:555">Clash between Turkish-backed mercenaries in Jarablus</s>
<s id="1:556">لە ئیدلب لە کاتی تێپەڕبوونی دەوریەی ڕووس و تورک تەقینەوەیەک ڕووید </s>	<s id="1:556">Explosion during Russian-Turkish joint patrol in Idlib</s>
<s id="1:557">سوپای داگیرکەر لە شەهبا هاوڵاتیەکی مەدەنی بریندار کرد </s>	<s id="1:557">Attack by occupation forces injures a civilian in Shehba</s>
<s id="1:558">داگیرکەران لە شاری باب ئاگریان بەردایە زەویە کشتوکاڵیەکان </s>	<s id="1:558">Occupiers burn down agricultural land in al-Bab</s>
<s id="1:559">تەرمی شەڕڤانی قەسەدە خالۆ کۆبانێ بەخاکسپێردرا </s>	<s id="1:559">SDF fighter laid to rest in Kobane</s>
<s id="1:560">ڕێگا بە هاوڵاتیان نادرێت بەشداری لە مەراسیمی تەرمی گۆکچەک بکەن </s>	<s id="1:560">Authorities try to prevent participation at Gökçek's funeral</s>
<s id="1:561">ئەنجوومەنى نێونەتەوەیی مافەکانی مرۆڤ داواى ئازادکردنی گولسەر یڵدرم دەکات </s>	<s id="1:561">IGFM calls for the release of HDP politician Gülser Yildirim</s>
<s id="1:562">گۆشەگیری لە کوچوک چەکمەجەى ئیستەنبول ئیدانە کرا </s>	<s id="1:562">Banners and slogans against isolation in Istanbul</s>
<s id="1:563">كه‌مپینێكی كۆكردنه‌وه‌ی ئیمزا بۆ پاراستنی حه‌سكیف ده‌ستی پێكرد </s>	<s id="1:563">Signature campaign for Hasankeyf</s>
<s id="1:564">هەپەگە ناسنامەی شەهیدانی زینی وەرتیێ ئاشکرا کرد </s>	<s id="1:564">HPG announces the names of Zînê Wertê martyrs</s>
<s id="1:565">هونەرمەند و رۆشنبیرانی رۆژهەڵاتی کوردستان: رێگا بە شەڕی ناوخۆ نەدەن </s>	<s id="1:565">Intellectuals in Rojhilat call for dialogue over South Kurdistan</s>
<s id="1:566">بەهۆی ئیدانەکردنی هێرشەکانی زینی وەرتێ ٥ کەس دەستگیرکران </s>	<s id="1:566">5 people jailed in Van for protesting the attack on Zini Werte</s>
<s id="1:567">کەژەکە: دەسەڵاتی ئاکەپە-مەهەپە بە دوای پلانێکی نوێی داگیرکاریەوەیە! </s>	<s id="1:567">KJK warns against new Turkish occupation plans</s>
<s id="1:568">هەپەگە: یادی شەهیدانی زاگرۆس بە بەرزی رادەگرین </s>	<s id="1:568">HPG pays tribute to five martyrs who fell in Zagros</s>
<s id="1:569">هێزەکانی گەریلا لە چەلێ لە بارەگا و سەنگەرەکانی سوپای تورکیدا </s>	<s id="1:569">HPG reports guerrilla action in Çele, air raid in South Kurdistan</s>
<s id="1:570">هەپەگە ناسنامەی ٣ گەریلای ئاشکرا کرد کە لە هەفتانین شەهید بوون </s>	<s id="1:570">HPG publishes names of three guerrillas who fell in Heftanin</s>
<s id="1:571">لە هەفتانینەوە تا سەرحەد گەریلا چالاکی ئەنجامدا: ٢٣ سەربازی تورک کوژران </s>	<s id="1:571">23 soldiers killed in guerrilla actions from Heftanin to Serhat</s>
<s id="1:572">یەژا-ستار لە هەفتانین چالاکیەکی ئەنجامدا </s>	<s id="1:572">YJA Star hit Turkish soldiers in Heftanin</s>
<s id="1:573">لە وان تیرۆری پۆلیسی تورک: ١٤ کەس دەستگیرکران </s>	<s id="1:573">Police raid houses, detain 14 people in Van</s>
<s id="1:574">سەربازە داگیرکەرەکانی تورک کێلی گۆڕی گەریلاکانیان شکاند </s>	<s id="1:574">Turkish soldiers desecrate guerrilla graves in Bingöl</s>
<s id="1:575">هەپەگە: ٢ ئەندامی میت و ٣ کۆنتر گەریلا کوژران </s>	<s id="1:575">HPG: Two MIT and three counter-guerrilla members killed in Amed</s>
<s id="1:576">هێزەکانی گەریلا لە ئامەد لە یەکە شاراوەکانیاندا: ٢ سەرباز کوژران </s>	<s id="1:576">Two soldiers killed as guerillas hit a covert military unit in Am</s>
<s id="1:577">هەپەگە: شەهید زنار ساسۆن بە رێزەوە بەبیر دێنینەوە </s>	<s id="1:577">HPG commander Zinar Sason martyred in Zap region</s>
<s id="1:578">هەپەگە: لە حەفتنانین سەربازێکى داگیرکەر کوژرا </s>	<s id="1:578">One Turkish soldier killed in Heftanin</s>
<s id="1:579">هەپەگە ناسنامەی گەریلایەکی ئاشکرا کرد کە لە سەرهەد شەهید بووە </s>	<s id="1:579">HPG commemorates guerrilla fighter Eriş Avent Pasin</s>
<s id="1:580">تەرمی گەریلای هەپەگە عەگید ئیپەک لە ڕێی پۆستەخانەوە بۆ بنەماڵەکەی ڕەوانەکرا </s>	<s id="1:580">Remains of HPG guerrilla sent to family by cargo</s>
<s id="1:581">باکوری کوردستان: چالاکییەکانی ژنان لەژێر گەمارۆی هێزەکانی پۆلیسدا بەڕێوەچوون </s>	<s id="1:581">Protests against feminicide banned in Northern Kurdistan</s>
<s id="1:582">ئەنجومەنی ژنانی هەدەپە: ٢٥ی تشرینی دووەم لە گۆڕەپان دەبین </s>	<s id="1:582">HDP calls on women to take to the streets on 25 November</s>
<s id="1:583">یەکێک لە کاندیدەکانی ATHENA40 ، سوسەن محەمەدی خەڵکی باشوورە </s>	<s id="1:583">Susan Mohammed from Bashur is one of ATHENA40's candidates</s>
<s id="1:584">توندوتیژیی دژ بە ژنان ٤٧ هێندە زیاترە لەو ئامارانەى بڵاودەکرێنەوە </s>	<s id="1:584">Violence against women cases 47 times higher than media reflects</s>
<s id="1:585">٧ کەس کە بە بۆنەی ٢٥ی تشرینی دووهەم بلاکراوەیان بڵاو کردەوە دەستگیر کران </s>	<s id="1:585">Istanbul police detain 7 people distributing leaflets for 25 Nov.</s>
<s id="1:586">لە باشوری کوردستان لە ماوەی ساڵێکدا بە دەیان ژن کوژراون </s>	<s id="1:586">Dozens of women murdered or committed suicide in South Kurdistan</s>
<s id="1:587">دۆسیەی مستەفا سەلیمی ڕەوانەی کۆمسیاری باڵای مافی مرۆڤی نەتەوەیەکگرتووەکان لە ژنێف کرا </s>	<s id="1:587">Mustafa Salimi's death sentence was carried out in Saqez Prison</s>
<s id="1:588">هاووڵاتییەکی کورد لەلایەن هێزە ئیتلاعاتییەکانەوە دەسبەسەر کرا </s>	<s id="1:588">A Kurdish citizen was arrested by Ettelaat</s>
<s id="1:589">چوار چالاکی فەرهەنگیی کورد بە ٣٦ مانگ زیندان مەحکووم کران </s>	<s id="1:589">Four Kurdish cultural activists have been sentenced to 36 months in prison</s>
<s id="1:590">زیندانییەکی پێشووی زیندانی سەقز دەسبەسەر کرا </s>	<s id="1:590">Arrest of a former prisoner in Saqez</s>
<s id="1:591">هاووڵاتییەک بە ساڵێک زیندانی تەعزیری مەحکووم کرا </s>	<s id="1:591">A Kurdish citizen sentenced to one year in discretionary imprisonment</s>
<s id="1:592">چالاکێکی ژینگەپارێزیی کورد بە ٦ ساڵ زیندانی تەعزیری مەحکووم کرد </s>	<s id="1:592">A Kurdish environmental activist was sentenced to six years in prison</s>
<s id="1:593">هاووڵاتییەکی کورد لە سنە دەسبەسەر کرا </s>	<s id="1:593">A Kurdish citizen was arrested in Sanandaj</s>
<s id="1:594">بەرێوەبەری سیاسیی نووسینگەی عەقیدەتی سیاسی فەرماندەییی گشتیی هێزە چەکدارەکانی ئێران هەڕەشەی لە حیزبی دێموکرات کرد </s>	<s id="1:594">IRGC officials threatened the PDKI with further attacks</s>
<s id="1:595">بەرپرسی ئیدارەی فەرهەنگ و ئیرشادی پاوە هەڕەشەی لە چالاکانی فەرهەنگی کرد </s>	<s id="1:595">The director of Ershad Bureau in Paweh threatened Kurdish cultural activists and poets</s>
<s id="1:596">هاووڵاتییەکی کورد پاش دەسبەسەرکرانی بۆ شوێنێکی نادیار ڕاگوێزرا </s>	<s id="1:596">A Kurdish citizen was taken to an unknown location after his arrest</s>
<s id="1:597">لەنێوان هێزەکانی سپای پاسداران و گرووپێکی چەکدار لە مەریوان تێکەڵچوون ڕوویدا </s>	<s id="1:597">Armed clash between Revolutionary Guards and an armed group in Marivan</s>
<s id="1:598">تەقەی هێزە نیزامییەکان لە سنووری ماکۆ سێ کۆڵبەری کردە قوربانی </s>	<s id="1:598">Three Kurdish Kolbars were killed and wounded in Bazargan, Maku</s>
<s id="1:599">زیندانییەک لە زیندانی سنە ئێعدام کرا </s>	<s id="1:599">Another prisoner executed in Sanandaj prison</s>
<s id="1:600">زیندانییەکی سیاسیی کورد لە زیندانی مەریوان بۆ زیندانی سنە ڕاگوێزرا </s>	<s id="1:600">Transfer of Kurdish political prisoner from Marivan prison to Sanandaj prison</s>
<s id="1:601">سێ کۆڵبەری کورد لە سنووری چاڵدێران پێکران </s>	<s id="1:601">Three Kurdish Kolbars were wounded at Chaldoran border</s>
<s id="1:602">"سەعید سەنگەر" بە ١٥ ساڵ زیندان مەحکووم کرا </s>	<s id="1:602">Saeed Sangar was sentenced to 15 years in prison</s>
<s id="1:603">"شایان سەعیدپوور'' لە سێدارە درا </s>	<s id="1:603">Shayan Saeedpour was executed</s>
<s id="1:604">ڕێوڕەسمی جێژنی نەورۆز لە مەلەکشاهیی ئیلام هەڵوەشایەوە </s>	<s id="1:604">Malakshahi\'s Nowruz Celebration was canceled</s>
<s id="1:605">ماوەی حەوتوویەک لە ناڕوونیی چارەنووسی "هیدایەت عەبدوڵڵاپوور" تێدەپەڕێت </s>	<s id="1:605">One week has passed since the forced disappearance of Hedayat Abdullahpour</s>
<s id="1:606">دوو هاووڵاتیی کورد بە هۆکاری نادیار دەسبەسەر کران </s>	<s id="1:606">Detention of two Kurdish citizens in Sanandaj for unknown reasons</s>
<s id="1:607">کۆڵبەرێکی کوردی سەردەشتی بە تەقەی هێزە نیزامییەکان گیانی لەدەست دا </s>	<s id="1:607">A Kurdish Kolbar was died after being shot by the government troops at the Sardasht's border</s>
<s id="1:608">دوو هاووڵاتیی دیکەی کورد لە زیندانەکانی سنە و ورمێ لە سێدارە دران </s>	<s id="1:608">Execution of two other prisoners in Sanandaj and Urmia</s>
<s id="1:609">دوو ساڵ زیندان بەسەر لاوێکی مەهابادیدا سەپا </s>	<s id="1:609">A young man from Mahabad was sentenced to two years in prison</s>
<s id="1:610">٥ هاووڵاتی بۆ گرتنگەی ئیتلاعاتی سپای پاسداران لە ورمێ ڕاگوێزران </s>	<s id="1:610">Transfer of five Kurdish citizens to Sepah Detention center in Urmia</s>
<s id="1:611">گوندی \"ساتیاری\" بە پێشوازیی نەورۆزەوە چوو </s>	<s id="1:611">Satiari welcomed Nowruz</s>
<s id="1:612">زیندانییەک لە زیندان بە تاوانی "کوشتنی بە ئەنقەست" لە زیندانی ورمێ ئێعدام کرا </s>	<s id="1:612">Execution of a prisoner accused of "murder" in Urmia Central Prison</s>
<s id="1:613">دوو هاووڵاتیی کوردی خەڵکی شنۆ لەلایەن هێزە ئەمنییەتییەکانەوە دەسبەسەر کران </s>	<s id="1:613">Two Kurdish youths from Oshnovieh were arrested by intelligence forces</s>
<s id="1:614">هاووڵاتییانی دانمارکی لە سەردانکردنی کوردستان، خووزستان و بەلووچستان، مەنح کران </s>	<s id="1:614">Danish citizens were discouraged from traveling to Kurdistan, Balochistan and Khuzestan</s>
<s id="1:615">لاوێکی مەریوانی بەهۆی هەڵگرتنی ئاڵای کوردستان دەسبەسەر کرا </s>	<s id="1:615">Arrest of another Kurdish youth in Marivan for raising Kurdistan flag</s>
<s id="1:616">بەرپرسی ئەنجومەنی فەرهەنگی- کۆمەڵایەتیی "نۆژین" لە کامیاران بە ٣ ساڵ زیندانی مەحکووم کرا </s>	<s id="1:616">Head of Nojin Socio-cultural Association Kamyaran's branch sentenced to three years in prison</s>
<s id="1:617">لە سنووری بانە کۆڵبەرێک بە تەقەی هێزە نیزامییەکان گیانی لەدەست دا </s>	<s id="1:617">A Kurdish Kolbar was died after government troops fired at the Baneh's border</s>
<s id="1:618">هاووڵاتییەک لە شاری سەرپێڵی‌زەهاو دەسبەسەر کرا </s>	<s id="1:618">Arrest of a Kurdish citizen in Sarpol-e Zahab</s>
<s id="1:619">تەقینەوەی مین، قرتاندنی لاقی لاوێکی لێکەوتەوە </s>	<s id="1:619">An injured young Ahvazi due to mine blast</s>
<s id="1:620">لاوێکی کورد پاش بانگهێشتکردنی بۆ ئیتلاعاتی ورمێ دەسبەسەر کرا </s>	<s id="1:620">A Kurdish youth was arrested after being summoned to Urmia's Ettelaat</s>
<s id="1:621">دوو کۆڵبەر لە سنووری سەردەشت بریندار بوون </s>	<s id="1:621">Two Kurdish Kolbars were wounded at the Sardasht border</s>
<s id="1:622">هاووڵاتییەک بە هۆی هەڵگرتنی ئاڵای کوردستان لە مەریوان دەسبەسەر کرا </s>	<s id="1:622">Arrest of a citizen for raising the Kurdistan flag</s>
<s id="1:623">هێزە لیباس شەخسییەکان لاوێکیان لە سنە دەسبەسەر کرد </s>	<s id="1:623">The plainclothes arrested a Kurdish youth in Sanandaj</s>
<s id="1:624">کەریم پەرویزی: ئێمە هیوادارین کە ئامریکا و وڵاتانی دیکە پشتیوانیی سیاسی لە خەباتی کورد لە کوردستانی رۆژهەڵات بکەن </s>	<s id="1:624">Karim Parwizi : we are looking forward to seeing the United States’ and other countries’ political support for the Kurdish movement in Rojhelat</s>
<s id="1:625">ئەماکن دەستی بە سەر کارتی هونەرمەندانی کامیارانی بۆ نەورۆز داگرت </s>	<s id="1:625">Bureau of Properties impounded Kamyaran Singer\'s artistry card</s>
<s id="1:626">هاووڵاتییەکی کورد لە کرماشان دەسبەسەر کرا </s>	<s id="1:626">A Kurdish citizen was arrested in Kermanshah</s>
<s id="1:627">هاووڵاتییەکی کرماشانی بە تۆمەتی "هاوکاری لەگەڵ یەکێک لە حیزبە کوردییەکان" دەسبەسەر کرا </s>	<s id="1:627">A Kermanshahi citizen was arrested for "cooperating with one of the Kurdish parties"</s>
<s id="1:628">حیزبی کۆمەڵە دەسبەسەر کردنی دوو پێشـەرگەی ئەو حیزبەی لە لایەن ئیتلاعاتەوە ڕەت کردەوە </s>	<s id="1:628">Komala Refutes the Iranian Ministry of Intelligence’s claim</s>
<s id="1:629">بە تەقەی هێزە نیزامییەکانی تورکیە دوو کۆڵبەر کوژران و بریندار بوون </s>	<s id="1:629">Two Kurdish Kolbars were killed and wounded after Turkish troops opened fire</s>
<s id="1:630">دەسبەسەرکردنی هاووڵاتییان لە پیرانشار درێژەی هەیە </s>	<s id="1:630">Kurdish citizens continue to be detained in Piranshahr</s>
<s id="1:631">"لوقمان ئەحمەدپوور" لە زیندانی سنە لەسێدارە درا </s>	<s id="1:631">Loghman Ahmadpour was executed in Sanandaj Central Prison</s>
<s id="1:632">دادسەرای نیزامیی ورمێ لەگەل لێخۆشبوون و ئازادیی بێمەرجی دوو زیندانیی سیاسیی کورد دژایەتیی کرد </s>	<s id="1:632">The Urmia Military Court has opposed the probation and parole of two Kurdish political prisoners</s>
<s id="1:633">لاوێکی کورد لە ورمێ دەسبەسەر کرا </s>	<s id="1:633">A Kurdish youth was arrested in Urmia</s>
<s id="1:634">لاوێکی تەمەن ١٨ ساڵ لە شنۆ دەسبەسەر کرا </s>	<s id="1:634">Arrest of a 18-year-old youth in Oshnavieh</s>
<s id="1:635">چیا سۆهرابی: عادڵ بەهرامی پاش گواستنەوەی بۆ کەمپی ئاگرێ، دیپۆرتی ئێران کرایەوە </s>	<s id="1:635">Chia Sohrabi: Adel Bahrami has been deported to Iran after moving to Agri Camp</s>
<s id="1:636">شۆرای تەئمینی سەقز بریارگەلێکی نوێی بۆ بەڕێوەچوونی جێژنی نەورۆز گرتەبەر </s>	<s id="1:636">Saghez Provision Council adopted decisions to deal vigorously with the New Year celebrations</s>
<s id="1:637">دوو لاوی کورد لە شارەکانی ورمێ و پیرانشار لەلایەن هێزە ئیتلاعاتییەکانەوە دەسبەسەر کران </s>	<s id="1:637">Two Kurdish youths were arrested by intelligence forces in Urmia and Piranshahr</s>
<s id="1:638">حوکمی زیندانیی چالاکێکی کرێکاری لە دادگای پێداچوونەوەی سنە پشتڕاست کرایەوە </s>	<s id="1:638">The sentence of a labor activist in the Sanandaj Court of Appeals was upheld</s>
<s id="1:639">مێرمنداڵێکی تەمەن ١٧ ساڵ لە پیرانشار دەسبەسەر کرا </s>	<s id="1:639">Arrest of a Kurdish teenager in Piranshahr</s>
<s id="1:640">حوکمی سێ ساڵ زیندانیی تەعزیری بەسەر "پەریسا سەیفی"دا سەپا </s>	<s id="1:640">Parisa Seifi sentenced to three years in discretionary prison</s>
<s id="1:641">تەقینەوەی گوللـە خومپارەیەک گیانی هاووڵاتییەکی کوردی تەمەن ٣٧ ساڵەی ئەستاند </s>	<s id="1:641">The bomb explosion killed a 37-year-old citizen in Sarpol Zahab</s>
<s id="1:642">کوژران و برینداربوونی ٣ کۆڵبەر بە تەقەی هێزە نیزامییەکانی حکوومەتی ئێران </s>	<s id="1:642">Three Kolbars killed and wounded by government gunfire</s>
<s id="1:643">سێ ئەندامی سپای پاسداران لە شەڕ و تێکەڵچوونێک لە "چلچەمە" کوژران </s>	<s id="1:643">Three members of the Revolutionary Guards were killed in a military clash</s>
<s id="1:644">ئاگرتێبەردانی ناوەندی فەرهەنگی_هونەری ڤەژین لە شاری مەریوان بە ئەنقەست بوو </s>	<s id="1:644">The fire set on Vajin, a Cultural-Artistic Center in Mariwan was intentional</s>
<s id="1:645">دوو هاووڵاتی لە پیرانشار بە هۆکاری نادیار دەسبەسەر کران </s>	<s id="1:645">Arrest of two Kurdish citizens in Piranshahr for unknown reasons</s>
<s id="1:646">ساڵی ٩٨ لە ئێران و کوردستان ٣٧ هاووڵاتی بەهۆی تەقینەوەی مین کوژراون و بریندار بوون </s>	<s id="1:646">37 civilians were killed and wounded in a landmine explosion in Iran and Kurdistan during 1398</s>
<s id="1:647">هاووڵاتییەک بۆ تێپەڕاندنی حوکمی بەندکران ڕەوانەی زیندانی ورمێ کرا </s>	<s id="1:647">Transfer of a citizen from Piranshahr to Urmia prison for serving his sentence</s>
<s id="1:648">زیندانییەک بە تاوانی "کوشتی بەئەنقەست" لە زیندانی سنە ئێعدام کرا </s>	<s id="1:648">The death sentence of a prisoner accused of "murder" was carried out in Sanandaj prison</s>
<s id="1:649">ئیدارەی فەرهەنگ و ئیرشادی ورمێ ئیزنی ڕێزگرتنیان بە "عوسمانە سوور" نەدا </s>	<s id="1:649">Osman Mustafa Pour, most prominent Kurdish political prisoner still deprived of leaving</s>
<s id="1:650">ئێران چەکێکی نوێی لەیزریی دروست کرد</s>	<s id="1:650">Iran unveils smart laser-guided projectile</s></p>